Australian Capital Territory	Australian Capital Territory
AustCapitalTerritory	Australian Capital Territory
AustCapitalTerrit	Australian Capital Territory
AusCap	Australian Capital Territory
AusCapTerrit	Australian Capital Territory
ACT	Australian Capital Territory
Jervis Bay Territory	Australian Capital Territory
Australian Captial Territory	Australian Capital Territory
A.C.T.	Australian Capital Territory
Act	Australian Capital Territory
(New Hebrides)	New Hebrides
New South Wales	New South Wales
nswales	New South Wales
nsw	New South Wales
New South Wales (including Coastal Waters)	New South Wales
?NSW	New South Wales
N.S.W.	New South Wales
NSW [query]	New South Wales
NSW?	New South Wales
New South Wales New South Wales	New South Wales
Nsw	New South Wales
Northern Territory	Northern Territory
nterritory	Northern Territory
nterrit	Northern Territory
nt	Northern Territory
Northern Territory (including Coastal Waters)	Northern Territory
N.T.	Northern Territory
NT?	Northern Territory
Queensland	Queensland
qland	Queensland
qld	Queensland
Queensland (including Coastal Waters)	Queensland
?QLD	Queensland
N. Qld	Queensland
QLD possibly	Queensland
QLD?	Queensland
Qld	Queensland
Qld [query]	Queensland
Qld?	Queensland
Queensland Queensland	Queensland
Queensland?	Queensland
South Auckland	South Auckland
South Auckland Land District	South Auckland
South Aukland	South Auckland
South Australia	South Australia
sthaustralia	South Australia
saustralia	South Australia
saust	South Australia
sa	South Australia
South Australia (including Coastal Waters)	South Australia
(SA)	South Australia
?SA	South Australia
S Aust	South Australia
S Aust.	South Australia
S. Aust	South Australia
S. Aust.	South Australia
S. Aust. waters	South Australia
S.A.	South Australia
S.Aust	South Australia
SA?	South Australia
South Australia?	South Australia
?South Dakota	South Dakota
South Island	South Island
South Island,	South Island
South Island, Sounds Nelson	South Island
South Island, West Nelson	South Island
South Island.	South Island
Stewart Island	Stewart island
Stewart Island.	Stewart island
Stewart island	Stewart island
Tasmania	Tasmania
tassie tas    Tasmania (including Coastal Waters)	Tasmania
NW Tasmania	Tasmania
Tasmania?	Tasmania
Tasmanian	Tasmania
Tas	Tasmania
Tas.	Tasmania
Tas?	Tasmania
Tasman	Tasmania
Tasman Penin	Tasmania
Victoria	Victoria
vic	Victoria
vict	Victoria
Victoria (including Coastal Waters)	Victoria
Vic	Victoria
Vic.	Victoria
Victoria.	Victoria
Western Australia	Western Australia
waustralia	Western Australia
westaustralia	Western Australia
westaust	Western Australia
wa	Western Australia
Western Australia (including Coastal Waters)	Western Australia
?Western Australia	Western Australia
W Aust	Western Australia
W Aust.	Western Australia
W. Aust	Western Australia
W. Aust.	Western Australia
W.A.	Western Australia
WA?	Western Australia
Wa	Western Australia
Wau	Western Australia
West Australia	Western Australia
Western Australia?	Western Australia
Western Australian	Western Australia
Western Austrlia	Western Australia
Western australia	Western Australia
Western australia w	Western Australia
Western Cape Province.	Western Cape Province
Western Cape	Western Cape Province
Western Cape Prov.	Western Cape Province
Western Cape Province	Western Cape Province
AU-WA	Western Australia
A`Ali An-Nil Province	A`Ali An-Nil Province
Aargau	Aargau
Aat	Aat
Abaing Atoll	Abaing Atoll
Aberdeen	Aberdeen
Abia State	Abia State
Abra	Abra
Abruzzese	Abruzzese
Abruzzo	Abruzzo
Absheron Rayon	Absheron Rayon
Acapulco	Acapulco
Aceh	Aceh
Aconcagua	Aconcagua
Acores	Acores
Acre	Acre
Adamawa	Adamawa
Adamawa Province	Adamawa Province
Adamawa State	Adamawa State
Adamit	Adamit
Adana	Adana
Adana Province	Adana Province
Adelie Land	Adelie Land
Aden	Aden
Adis Abeba	Adis Abeba
Adjuntas	Adjuntas
Admiralty Islands	Admiralty Islands
Admiralty group	Admiralty group
Admiralty, Manus Island	Admiralty, Manus Island
Agalega	Agalega
Agalega Islands	Agalega Islands
Agdam Rayonu	Agdam Rayonu
Aghstafa Rayon	Aghstafa Rayon
Agia Marina egina Isl.	Agia Marina egina Isl.
Agneby	Agneby
Aguascalientes	Aguascalientes
Agusan Norte	Agusan Norte
Ahal Welayaty	Ahal Welayaty
Ahvenanmaan maakunta	Ahvenanmaan maakunta
Aibonito	Aibonito
Aichi Prefecture	Aichi Prefecture
Aichi-ken	Aichi-ken
Aileu District	Aileu District
Ain Defla	Ain Defla
Ain Temouchent	Ain Temouchent
Ainaro	Ainaro
Ainaro District	Ainaro District
Airai	Airai
Aisen	Aisen
Aisen Province	Aisen Province
Akaroa	Akaroa
Akershus Fylke	Akershus Fylke
Akhalk¬¥alak¬¥is Raioni	Akhalk¬¥alak¬¥is Raioni
Akwa Ibom	Akwa Ibom
Al Bahr al Ahmar	Al Bahr al Ahmar
Al Iskandariyah	Al Iskandariyah
Al Jazirah	Al Jazirah
Al Jizah	Al Jizah
Al Khartum	Al Khartum
Al Mintaqah ad Dakhiliyah	Al Mintaqah ad Dakhiliyah
Al Uqsur	Al Uqsur
Ala	Ala
Alabama	Alabama
Alagoas	Alagoas
Alagoas state	Alagoas state
Alajuela	Alajuela
Aland	Aland
Alandia	Alandia
Alaotra-Mangoro	Alaotra-Mangoro
Alaska	Alaska
Alaska Juneau	Alaska Juneau
Alba	Alba
Alba County	Alba County
Albay	Albay
Albay Province	Albay Province
Alberta	Alberta
Alborz	Alborz
Aldabra Island	Aldabra Island
Algarve	Algarve
Alger	Alger
Algeria	Algeria
Algiers	Algiers
Alicante	Alicante
Alicante Province	Alicante Province
Almadies	Almadies
Almatinskaya Oblast'	Almatinskaya Oblast'
Almeria	Almeria
Almora District	Almora District
Alpes-De-Haute-Provence	Alpes-De-Haute-Provence
Alpes-Maritimes	Alpes-Maritimes
Alsace	Alsace
Alta Verapaz	Alta Verapaz
Altaverapaz	Altaverapaz
Altay	Altay
Altayskiy Kray	Altayskiy Kray
Amami	Amami
Amapa	Amapa
Amara	Amara
Amazonas	Amazonas
Ambon	Ambon
Ambon Island	Ambon Island
Ambrym	Ambrym
American Samoa	American Samoa
American Samoa, Manu'a	American Samoa, Manu'a
American Samoa, Tutuila	American Samoa, Tutuila
Amurskaya Oblast'	Amurskaya Oblast'
An Clar	An Clar
An Giang	An Giang
An Iarmhi	An Iarmhi
An Nil	An Nil
An Nil al Abyad	An Nil al Abyad
An Nil al Azraq	An Nil al Azraq
Anak Krakatau	Anak Krakatau
Analamanga	Analamanga
Analamanga Region	Analamanga Region
Analanjirofo	Analanjirofo
Ancash	Ancash
Andalucia	Andalucia
Andaman And Nicobar Islands	Andaman And Nicobar Islands
Andaman Islands	Andaman Islands
Andaman and Nicobar Islands	Andaman and Nicobar Islands
Andaman and Nicobar Islands Territory	Andaman and Nicobar Islands Territory
Andhra Pradesh	Andhra Pradesh
Andra Pradesh	Andra Pradesh
Andros island	Andros island
Androy	Androy
Aneityum	Aneityum
Angermanland	Angermanland
Angonia	Angonia
Angus	Angus
Anhui	Anhui
Anhui Sheng	Anhui Sheng
Anjouan	Anjouan
Ankara	Ankara
Annaba	Annaba
Anosy	Anosy
Anseba	Anseba
Ant	Ant
Antalya	Antalya
Antananarivo	Antananarivo
Antanarivo Province	Antanarivo Province
Antarctic Peninsula	Antarctic Peninsula
Antarctic Region	Antarctic Region
Antarctic Region Macquarie Island	Antarctic Region Macquarie Island
Antarctica	Antarctica
Antartica Chilena Province	Antartica Chilena Province
Antigua	Antigua
Antigue Province	Antigue Province
Antilles	Antilles
Antioquia	Antioquia
Antipodean Islands	Antipodean Islands
Antipodes Islands	Antipodes Islands
Antofagasta	Antofagasta
Antsiranana	Antsiranana
Antwerp	Antwerp
Anzoategui	Anzoategui
Aomori Prefecture	Aomori Prefecture
Aomori-ken	Aomori-ken
Aosta	Aosta
Ap'khazet'is Avtonomiuri Respublika	Ap'khazet'is Avtonomiuri Respublika
Appenzell Ausserrhoden	Appenzell Ausserrhoden
Appenzell Innerrhoden	Appenzell Innerrhoden
Apulia	Apulia
Apure State	Apure State
Aqtobe Oblysy	Aqtobe Oblysy
Aquitaine	Aquitaine
Arad	Arad
Arafura Sea	Arafura Sea
Aragua	Aragua
Arakan Coast	Arakan Coast
Ararati Marz	Ararati Marz
Arauca	Arauca
Araucania	Araucania
Arauco	Arauco
Arbil	Arbil
Arecibo	Arecibo
Arecibo District	Arecibo District
Arequipa	Arequipa
Arequipa Department	Arequipa Department
Argentina	Argentina
Arges	Arges
Argyll	Argyll
Argyll and Bute	Argyll and Bute
Arima	Arima
Arizona	Arizona
Arkansas	Arkansas
Artvin Province	Artvin Province
Aru Islands	Aru Islands
Arunachal Pradesh	Arunachal Pradesh
Arusha Region	Arusha Region
Ash Shamaliyah	Ash Shamaliyah
Ashanti	Ashanti
Ashanti Region	Ashanti Region
Ashgabat Province	Ashgabat Province
Ashmore & Cartier Islands	Ashmore & Cartier Islands
Ashmore and Cartier Islands	Ashmore and Cartier Islands
Asia	Asia
Assam	Assam
Astrakhanskaya Oblast'	Astrakhanskaya Oblast'
Asturias	Asturias
Aswan	Aswan
Atacama	Atacama
Atacama Region	Atacama Region
Atakora	Atakora
Atakora Department	Atakora Department
Atiu	Atiu
Atlantic Ocean	Atlantic Ocean
Atlantico	Atlantico
Atlantida	Atlantida
Atlantique	Atlantique
Atsimo-Andrefana	Atsimo-Andrefana
Atsimo-Atsinanana Region	Atsimo-Atsinanana Region
Atsinanana	Atsinanana
Attica	Attica
Atua	Atua
Atyrau Oblysy	Atyrau Oblysy
Auckland	Auckland
Auckland Island	Auckland Island
Auckland Islands	Auckland Islands
Auckland Region	Auckland Region
Aukena Island	Aukena Island
Aukland	Aukland
Aurora	Aurora
Aurora Province	Aurora Province
Aus	Aus
Austral Islands	Austral Islands
Austral Isles	Austral Isles
Austral [Tubuai] Islands	Austral [Tubuai] Islands
Australian Antarctic Territories	Australian Antarctic Territories
Australian Antarctic Territory	Australian Antarctic Territory
Australian Christmas Island Territory	Australian Christmas Island Territory
Australian Norfolk Island Territory	Australian Norfolk Island Territory
Austria	Austria
Austurland	Austurland
Auvergne	Auvergne
Aveyron	Aveyron
Avila	Avila
Avtonomna Respublika Krym	Avtonomna Respublika Krym
Ayacucho	Ayacucho
Aydin	Aydin
Ayeyarwady Division	Ayeyarwady Division
Ayrshire	Ayrshire
Ayutthia	Ayutthia
Azad Kashmir	Azad Kashmir
Azarbayjan-e Gharbi	Azarbayjan-e Gharbi
Azarbayjan-e Sharqi	Azarbayjan-e Sharqi
Azores	Azores
Azuay	Azuay
BORNEO-NORTH	BORNEO-NORTH
BR. COLUMBIA	BR. COLUMBIA
Ba District	Ba District
Ba Ria-Vung Tau	Ba Ria-Vung Tau
Baalbek-Hermel	Baalbek-Hermel
Babil	Babil
Bac Binh District	Bac Binh District
Bac Lieu Province	Bac Lieu Province
Bacacay	Bacacay
Bacau	Bacau
Bacau District	Bacau District
Bacs-Kiskun megye	Bacs-Kiskun megye
Badajoz	Badajoz
Baden-Wuerttemberg	Baden-Wuerttemberg
Baden-Wurttemberg	Baden-Wurttemberg
Baden-Wurttemburg	Baden-Wurttemburg
Baffin Island	Baffin Island
Bafing	Bafing
Baghdad	Baghdad
Baghlan	Baghlan
Bagmati	Bagmati
Bago Division	Bago Division
Bago Region	Bago Region
Baguio City	Baguio City
Bahamas	Bahamas
Bahia	Bahia
Bahia de Adair	Bahia de Adair
Bahia state	Bahia state
Bahr al Ahmar	Bahr al Ahmar
Bahrain	Bahrain
Baile Atha Cliath	Baile Atha Cliath
Baja California	Baja California
Baja California Norte	Baja California Norte
Baja California Sur	Baja California Sur
Baja California del Norte	Baja California del Norte
Baja California.	Baja California.
Baja Verapaz	Baja Verapaz
Baja califonia sur	Baja califonia sur
Baja california	Baja california
Baja california sur	Baja california sur
Baki Sahari	Baki Sahari
Baku City	Baku City
Balakan Rayonu	Balakan Rayonu
Baleares	Baleares
Balearic Islands	Balearic Islands
Bali	Bali
Balkan Welayaty	Balkan Welayaty
Balkh	Balkh
Balleny Islands	Balleny Islands
Ballycastle	Ballycastle
Balochistan	Balochistan
Balqa'	Balqa'
Baltic Sea	Baltic Sea
Baluchistan	Baluchistan
Balud	Balud
Balut Island	Balut Island
Bamako	Bamako
Banatus	Banatus
Bandarban Hill Distrcit	Bandarban Hill Distrcit
Bangkok	Bangkok
Bangui	Bangui
Banjul	Banjul
Banks	Banks
Banskobystricky Kraj	Banskobystricky Kraj
Banteay Mean Cheay	Banteay Mean Cheay
Banteay Meanchey Province	Banteay Meanchey Province
Banteay Mincheay	Banteay Mincheay
Banten	Banten
Barahona	Barahona
Baranya megye	Baranya megye
Barat Province	Barat Province
Barbados	Barbados
Bari	Bari
Barima-Waini Region	Barima-Waini Region
Barinas	Barinas
Baringo County	Baringo County
Bas-Sassandra	Bas-Sassandra
Basel-Landschaft	Basel-Landschaft
Basel-Stadt	Basel-Stadt
Bashkortostan	Bashkortostan
Basilan	Basilan
Basilan Province	Basilan Province
Basilicata	Basilicata
Basrah	Basrah
Bata District	Bata District
Bata Province	Bata Province
Bataan	Bataan
Bataan Province	Bataan Province
Batanes	Batanes
Batangas	Batangas
Batangas Province	Batangas Province
Batdambang	Batdambang
Batinah	Batinah
Batna	Batna
Battambang Province	Battambang Province
Battambong	Battambong
Batys Qazaqstan Oblysy	Batys Qazaqstan Oblysy
Baucau	Baucau
Baucau District	Baucau District
Bauchi	Bauchi
Baukai Island	Baukai Island
Bavaria	Bavaria
Bavaria (Bayern)	Bavaria (Bayern)
Bay of Plenty	Bay of Plenty
Bay of Plenty Region	Bay of Plenty Region
Bechar	Bechar
Bedfordshire	Bedfordshire
Beheira	Beheira
Beijing Shi	Beijing Shi
Beja	Beja
Bekes megye	Bekes megye
Bel Ombre	Bel Ombre
Belait	Belait
Belgium	Belgium
Belize District	Belize District
Bellinghausen Sea	Bellinghausen Sea
Bellune	Bellune
Belluno	Belluno
Ben Arous	Ben Arous
Bengal	Bengal
Bengkulu	Bengkulu
Bengkulu Province	Bengkulu Province
Bengo	Bengo
Benguela	Benguela
Benguet	Benguet
Beqaa	Beqaa
Bequia	Bequia
Berane	Berane
Berea District	Berea District
Berkshire	Berkshire
Berlin	Berlin
Bermuda	Bermuda
Bern	Bern
Berne	Berne
Beunos Aires	Beunos Aires
Beyrouth	Beyrouth
Bicol Region	Bicol Region
Bihar	Bihar
Bihar State of	Bihar State of
Bihor	Bihor
Binh Dinh	Binh Dinh
Binh Phuoc	Binh Phuoc
Binh Thuan	Binh Thuan
Binh Thuan Province	Binh Thuan Province
Binh Tri Thien	Binh Tri Thien
Binshangul Gumuz	Binshangul Gumuz
Bio Bio	Bio Bio
Bio-Bio	Bio-Bio
Biobio	Biobio
Bioko	Bioko
Bird Island	Bird Island
Bishkek Shaary	Bishkek Shaary
Biskra	Biskra
Bismarck Archipelago	Bismarck Archipelago
Bismarck Sea	Bismarck Sea
Bismark Group	Bismark Group
Bistrita-Nasaud	Bistrita-Nasaud
Bitola	Bitola
Bizerte	Bizerte
Bjelovarsko-Bilogorska Zupanija	Bjelovarsko-Bilogorska Zupanija
Black River	Black River
Blagoevgrad	Blagoevgrad
Blekinge	Blekinge
Blekinge Lan	Blekinge Lan
Blida	Blida
Boaco	Boaco
Boane	Boane
Bobonaro District	Bobonaro District
Bocas Toro	Bocas Toro
Bogota	Bogota
Bogovinje	Bogovinje
Bohemia	Bohemia
Bohinj	Bohinj
Bohol	Bohol
Bohuslan	Bohuslan
Bohuslan Province	Bohuslan Province
Bohusl√§n	Bohusl√§n
Boke	Boke
Bokeo	Bokeo
Bolama	Bolama
Bolivar	Bolivar
Bolu	Bolu
Bombay	Bombay
Bontoc	Bontoc
Boqueron	Boqueron
Bora Bora	Bora Bora
Border of East Sepik & West Sepik (Sandaun) Provinces	Border of East Sepik & West Sepik (Sandaun) Provinces
Bordj Bou Arreridj	Bordj Bou Arreridj
Borgou	Borgou
Borishal	Borishal
Bormio	Bormio
Borneo	Borneo
Borno	Borno
Borsod-Abauj-Zemplen megye	Borsod-Abauj-Zemplen megye
Botosani	Botosani
Bougainville	Bougainville
Bougainville District	Bougainville District
Bougainville Island	Bougainville Island
Bougainville Province	Bougainville Province
Bouira	Bouira
Boumerdes	Boumerdes
Bounty Islands	Bounty Islands
Bourail	Bourail
Bourbon Island	Bourbon Island
Bourgogne-Franche-Comt√©	Bourgogne-Franche-Comt√©
Bouvetoya	Bouvetoya
Boyaca	Boyaca
Bragan√ßa	Bragan√ßa
Brandenburg	Brandenburg
Brasov	Brasov
Bratislavsky Kraj	Bratislavsky Kraj
Brava	Brava
Brazil	Brazil
Brazzaville	Brazzaville
Bremen	Bremen
Brestskaya Voblasts'	Brestskaya Voblasts'
Bretagne	Bretagne
Brit. Columbia	Brit. Columbia
British Antarctic Territory	British Antarctic Territory
British Colombia	British Colombia
British Columbia	British Columbia
British Indian Ocean Territory	British Indian Ocean Territory
British columbia	British columbia
Brittany	Brittany
Brittish Columbia	Brittish Columbia
Brokopondo	Brokopondo
Brong Ahafo	Brong Ahafo
Bruin Island	Bruin Island
Brunei-Muara	Brunei-Muara
Bruxelles-Capitale	Bruxelles-Capitale
Brz	Brz
Bubanza	Bubanza
Buckinghamshire	Buckinghamshire
Bucuresti	Bucuresti
Budapest fovaros	Budapest fovaros
Buenos Aires	Buenos Aires
Buenos Aires Province	Buenos Aires Province
Buganda	Buganda
Buhayrah	Buhayrah
Bujumbura	Bujumbura
Buka Island	Buka Island
Bukhara	Bukhara
Bukidnon	Bukidnon
Bulacan	Bulacan
Bulawayo Province	Bulawayo Province
Bulgaria	Bulgaria
Bumthang	Bumthang
Burgas	Burgas
Burgas Province	Burgas Province
Burgenland	Burgenland
Bursa	Bursa
Bururi	Bururi
Bururi Province	Bururi Province
Buryatia Prov.	Buryatia Prov.
Buryatiya	Buryatiya
Bushehr	Bushehr
Buskerud Fylke	Buskerud Fylke
Butha-Buthe District	Butha-Buthe District
Butuan City	Butuan City
Buxoro Viloyati	Buxoro Viloyati
Buzau	Buzau
B√≠o B√≠o	B√≠o B√≠o
B√≠o B√≠o Region	B√≠o B√≠o Region
B√≠o-B√≠o	B√≠o-B√≠o
Ca	Ca
Caanuazu	Caanuazu
Cabo Delgado	Cabo Delgado
Caceres	Caceres
Cadiz	Cadiz
Cadiz Province	Cadiz Province
Cagayan	Cagayan
Cagayan Province	Cagayan Province
Cagayan province	Cagayan province
Cailfornia	Cailfornia
Cairo	Cairo
Cairo Governorate	Cairo Governorate
Cajamarca	Cajamarca
Cakaudrove	Cakaudrove
Calabarzon	Calabarzon
Calabria	Calabria
Calarasi	Calarasi
Caldas	Caldas
Califormia	Califormia
California	California
California Baja	California Baja
Callao	Callao
Callao Province	Callao Province
Caluan	Caluan
Camaguey	Camaguey
Camarines Norte	Camarines Norte
Camarines Sur	Camarines Sur
Camarines Sur Prov.	Camarines Sur Prov.
Camarines sur prov	Camarines sur prov
Cambodia	Cambodia
Cambridgeshire	Cambridgeshire
Camer	Camer
Cameroon	Cameroon
Camiguin	Camiguin
Campania	Campania
Campbell Island	Campbell Island
Campbell Island.	Campbell Island.
Campbell Islands	Campbell Islands
Campeche	Campeche
Campeche State	Campeche State
Can Tho	Can Tho
Canada	Canada
Canal Zone	Canal Zone
Canal zone	Canal zone
Canar	Canar
Canarias	Canarias
Canary Is.	Canary Is.
Canary Islands	Canary Islands
Canelones	Canelones
Cankiri	Cankiri
Cankuzo	Cankuzo
Cantabria	Cantabria
Cantabria Province	Cantabria Province
Canterbury	Canterbury
Canterbury Land District	Canterbury Land District
Canton Aargau	Canton Aargau
Canton Schwyz	Canton Schwyz
Cap Mannel	Cap Mannel
Cape	Cape
Cape Peninsula	Cape Peninsula
Cape Province	Cape Province
Cape Province.	Cape Province.
Cape Provinces	Cape Provinces
Cape Town	Cape Town
Cape Verde Islands	Cape Verde Islands
Cape Verdi Islands	Cape Verdi Islands
Cape of Good Hope	Cape of Good Hope
Cape province	Cape province
Capiz	Capiz
Capiz Province	Capiz Province
Carabaya	Carabaya
Carabobo	Carabobo
Caras-Severin	Caras-Severin
Carchi	Carchi
Carchi Province	Carchi Province
Cargados Carajos	Cargados Carajos
Cargados carajos	Cargados carajos
Caribbean Sea	Caribbean Sea
Carinthia	Carinthia
Carinthia (Karnten)	Carinthia (Karnten)
Caroline Islands	Caroline Islands
Cartago	Cartago
Cartago Province	Cartago Province
Cartago-San Jos√©	Cartago-San Jos√©
Casbar	Casbar
Caspian Sea	Caspian Sea
Castelo Branco	Castelo Branco
Castilla y Leon	Castilla y Leon
Castilla y LeÔøΩn	Castilla y LeÔøΩn
Castilla-La Mancha	Castilla-La Mancha
Castille	Castille
Catalonia	Catalonia
Catalunya	Catalunya
Catalu√±a	Catalu√±a
Catamarca	Catamarca
Catanduanes	Catanduanes
Catham Islands	Catham Islands
Cauca	Cauca
Cauquenes	Cauquenes
Caust	Caust
Cautin	Cautin
Cautin Province	Cautin Province
Cavite	Cavite
Cavite Province	Cavite Province
Caxaca	Caxaca
Cayman Islands	Cayman Islands
Cayo	Cayo
Cayo District	Cayo District
Ceara	Ceara
Ceara State	Ceara State
Cear√°	Cear√°
Cebaco Is.	Cebaco Is.
Cebu	Cebu
Cebu City	Cebu City
Cebu Island	Cebu Island
Celebes	Celebes
Celebes Sea	Celebes Sea
Celle	Celle
Central	Central
Central Australia South	Central Australia South
Central Bohemia	Central Bohemia
Central Denmark Region	Central Denmark Region
Central District	Central District
Central Division	Central Division
Central Equatoria	Central Equatoria
Central European Russia	Central European Russia
Central Greece	Central Greece
Central Java	Central Java
Central Luzon	Central Luzon
Central Macedonia	Central Macedonia
Central Nepal	Central Nepal
Central Province	Central Province
Central Provinces	Central Provinces
Central Region	Central Region
Central River Division	Central River Division
Central Sahara	Central Sahara
Central Serbia	Central Serbia
Central Slovakia	Central Slovakia
Central Sulawesi	Central Sulawesi
Central Uganda	Central Uganda
Central Visayas	Central Visayas
Central java	Central java
Central kalimantan	Central kalimantan
Central sulawesi	Central sulawesi
Centre	Centre
Cerklje na Gorenjskem	Cerklje na Gorenjskem
Cerro Largo	Cerro Largo
Cetinje	Cetinje
Ceuta	Ceuta
Chabahar Bay	Chabahar Bay
Chachoengsao Province	Chachoengsao Province
Chaco	Chaco
Chagos Archipelago	Chagos Archipelago
Chahar Mahall va Bakhtiari	Chahar Mahall va Bakhtiari
Chaiyaphum	Chaiyaphum
Chakrala	Chakrala
Chalatenango	Chalatenango
Champasak	Champasak
Chang Wat Chiang Rai	Chang Wat Chiang Rai
Chang Wat Lampang	Chang Wat Lampang
Changwat Chiang Mai	Changwat Chiang Mai
Changwat Chiang Rai	Changwat Chiang Rai
Channel Islands	Channel Islands
Chantaburi Province	Chantaburi Province
Chanthaburi	Chanthaburi
Chanthaburi Province	Chanthaburi Province
Chaouia-Ouardigha	Chaouia-Ouardigha
Chari-Baguirmi Region	Chari-Baguirmi Region
Chatams	Chatams
Chatham Island	Chatham Island
Chatham Islands	Chatham Islands
Chathams	Chathams
Chatillon	Chatillon
Cheju	Cheju
Cheju-do	Cheju-do
Chelyabinskaya Oblast'	Chelyabinskaya Oblast'
Chernihivs'ka Oblast'	Chernihivs'ka Oblast'
Chhattisgarh	Chhattisgarh
Chhukha	Chhukha
Chia-I Hsien	Chia-I Hsien
Chiang Mai	Chiang Mai
Chiang Mai Province	Chiang Mai Province
Chiang Rai Province	Chiang Rai Province
Chiapas	Chiapas
Chiba	Chiba
Chiba Pref.	Chiba Pref.
Chiba-ken	Chiba-ken
Chihuahua	Chihuahua
Chikwawa District	Chikwawa District
Chilae	Chilae
Chile	Chile
Chiloe	Chiloe
Chiloe Province	Chiloe Province
Chilo√©	Chilo√©
Chimaltenango	Chimaltenango
Chimanimani	Chimanimani
Chimborazo	Chimborazo
Chimbu	Chimbu
Chimbu (Simbu) Province	Chimbu (Simbu) Province
Chimbu Province	Chimbu Province
China	China
China North-Central	China North-Central
China Southeast	China Southeast
China?	China?
Chiradzulu District	Chiradzulu District
Chiriqui	Chiriqui
Chiriqui Province	Chiriqui Province
Chiriqu√≠	Chiriqu√≠
Chisinau	Chisinau
Chitinskaya Oblast'	Chitinskaya Oblast'
Chitipa District	Chitipa District
Chittagong	Chittagong
Chittagong Division	Chittagong Division
Choapa	Choapa
Choapa Province	Choapa Province
Choiseul	Choiseul
Choiseul Province	Choiseul Province
Choiseul is	Choiseul is
Chon Buri Province	Chon Buri Province
Chonburi	Chonburi
Chonburi Prov.	Chonburi Prov.
Chonburi Province	Chonburi Province
Chongqing	Chongqing
Chongqing Shi	Chongqing Shi
Christchurch	Christchurch
Christmas Is.	Christmas Is.
Christmas Island	Christmas Island
Christmas island	Christmas island
Chubu	Chubu
Chubut	Chubut
Chubut Province	Chubut Province
Chugoku	Chugoku
Chukotskiy Avtonomnyy Okrug	Chukotskiy Avtonomnyy Okrug
Chumphon	Chumphon
Chumphon Province	Chumphon Province
Chungcheongbuk-do	Chungcheongbuk-do
Chungcheongnam-do	Chungcheongnam-do
Chuquisaca	Chuquisaca
Chuuk	Chuuk
Chuyskaya Oblast'	Chuyskaya Oblast'
Ci	Ci
Ciarrai	Ciarrai
Cidade de Maputo	Cidade de Maputo
Cienfuegos	Cienfuegos
Cill Mhantain	Cill Mhantain
Cimislia	Cimislia
Ciudad de La Habana	Ciudad de La Habana
Clarence Island	Clarence Island
Clay	Clay
Cluj	Cluj
Cluj Co.	Cluj Co.
Cnmi	Cnmi
Co. Wick	Co. Wick
Coahuila	Coahuila
Coahuila de Zaragoza	Coahuila de Zaragoza
Coast	Coast
Coast Province	Coast Province
Coast province	Coast province
Coats Land	Coats Land
Cochabamba	Cochabamba
Cocle	Cocle
Cocos (Keeling)	Cocos (Keeling)
Cocos (Keeling) Islands	Cocos (Keeling) Islands
Cocos Islands	Cocos Islands
Cocos Keeling Islands	Cocos Keeling Islands
Coimbra	Coimbra
Cojedes	Cojedes
Col d'Amieu	Col d'Amieu
Colchagua	Colchagua
Colima	Colima
Colima State	Colima State
Colombia	Colombia
Colon	Colon
Colon province	Colon province
Colorado	Colorado
Columbia	Columbia
Comarca de San Blas	Comarca de San Blas
Comayagua	Comayagua
Commonwealth Territory	Commonwealth Territory
Concepcion	Concepcion
Concepci√≥n	Concepci√≥n
Connaught	Connaught
Connecticut	Connecticut
Conneticut	Conneticut
Constanta	Constanta
Constanta Co.	Constanta Co.
Constantine	Constantine
Constantine Prov	Constantine Prov
Cook Islands	Cook Islands
Cook i	Cook i
Copperbelt Province	Copperbelt Province
Coquimbo	Coquimbo
Coquimbo Province	Coquimbo Province
Coral Sea	Coral Sea
Coral Sea Island Territory	Coral Sea Island Territory
Coral Sea Islands	Coral Sea Islands
Coral Sea Islands Territory	Coral Sea Islands Territory
Coral Sea Territory	Coral Sea Territory
Cordoba	Cordoba
Coringa Islets	Coringa Islets
Cork	Cork
Cornwall	Cornwall
Corrientes	Corrientes
Corse	Corse
Corsica	Corsica
Cort√©s	Cort√©s
Costa Rica	Costa Rica
Cotabato City	Cotabato City
Cotal	Cotal
Cotopaxi	Cotopaxi
Coulon	Coulon
County Clare	County Clare
County Cork	County Cork
County Donegal	County Donegal
County Down	County Down
County Fermanagh	County Fermanagh
County Galway	County Galway
County Kerry	County Kerry
County Mayo	County Mayo
Covalima District	Covalima District
Covasna	Covasna
Cox's Bazar	Cox's Bazar
Crete	Crete
Crimea	Crimea
Cross River State	Cross River State
Csongrad	Csongrad
Csongrad megye	Csongrad megye
Cuanza Norte	Cuanza Norte
Cuanza Sul	Cuanza Sul
Cuanza Sul Province	Cuanza Sul Province
Cuddalore	Cuddalore
Cundinamarca	Cundinamarca
Cundinamarca Prov.	Cundinamarca Prov.
Curacao	Curacao
Cusco	Cusco
Cusco Region	Cusco Region
Cuyuni-Mazaruni	Cuyuni-Mazaruni
Cuyuni-Mazaruni Region	Cuyuni-Mazaruni Region
Cuzco	Cuzco
Cyprus	Cyprus
Cyrenaica	Cyrenaica
C√¥tes-D'armor	C√¥tes-D'armor
D'entrecasteaux Islands	D'entrecasteaux Islands
D.C.	D.C.
D.c.	D.c.
DPTO de Lavalleja	DPTO de Lavalleja
Da Nang	Da Nang
Dac Lac	Dac Lac
Dac Lak	Dac Lak
Daga	Daga
Dagahlia Province	Dagahlia Province
Dagestan	Dagestan
Dahuk	Dahuk
Dak Lak Province	Dak Lak Province
Dak Nong	Dak Nong
Dakar	Dakar
Dakota	Dakota
Dalarna	Dalarna
Dalarnas Lan	Dalarnas Lan
Dalsland	Dalsland
Daman and Diu	Daman and Diu
Damascus Governorate	Damascus Governorate
Dambovita	Dambovita
Dar`a	Dar`a
Darien	Darien
Darjeeling	Darjeeling
Dasoguz Welayaty	Dasoguz Welayaty
Davao	Davao
Davao City	Davao City
Davao Oriental	Davao Oriental
Davao Region	Davao Region
Davao Sur	Davao Sur
Dc	Dc
Debub	Debub
Debubawi K'eyih Bahri	Debubawi K'eyih Bahri
Delaware	Delaware
Delhi	Delhi
Delta State	Delta State
Demerara-Mahaica Region	Demerara-Mahaica Region
Denbighshire	Denbighshire
Denizli	Denizli
Denmark	Denmark
Departamento del Beni	Departamento del Beni
Departamento del Valle del Cauca	Departamento del Valle del Cauca
Departement de l' Alibori	Departement de l' Alibori
Departement du Mono	Departement du Mono
Department of Granada	Department of Granada
Department of Magdalena	Department of Magdalena
Dept La Union	Dept La Union
Dept. Canelones	Dept. Canelones
Dept. De L'Ouest	Dept. De L'Ouest
Dept. Du Sud	Dept. Du Sud
Dept. Pando	Dept. Pando
Dept. Santa Cruz	Dept. Santa Cruz
Depto Canelones	Depto Canelones
Depto Colonia	Depto Colonia
Depto Lavalleja	Depto Lavalleja
Depto Rivera	Depto Rivera
Depto Rocha	Depto Rocha
Depto Santa Cruz	Depto Santa Cruz
Depto Tacuarembo	Depto Tacuarembo
Depto Treinta Y Tres	Depto Treinta Y Tres
Depto de Amazonas	Depto de Amazonas
Depto de Boyac√°	Depto de Boyac√°
Depto de Nari√±o	Depto de Nari√±o
Depto. Cochabamba	Depto. Cochabamba
Depto. La Paz	Depto. La Paz
Depto. Santa Cruz	Depto. Santa Cruz
Derbyshire	Derbyshire
Devon	Devon
Dgo	Dgo
Dhaka	Dhaka
Dhaka Division	Dhaka Division
Diana Region	Diana Region
Diffa	Diffa
Dili	Dili
Dili District	Dili District
Dillkreis	Dillkreis
Dimashq	Dimashq
Dist. Columbia	Dist. Columbia
District of Colombia	District of Colombia
District of Columbia	District of Columbia
Distrito Federal	Distrito Federal
Diyarbakir	Diyarbakir
Dobrich	Dobrich
Dodoma Region	Dodoma Region
Dolj	Dolj
Dolnoslaskie	Dolnoslaskie
Donegal	Donegal
Donets'ka Oblast'	Donets'ka Oblast'
Dong Nai	Dong Nai
Dong Nai Province	Dong Nai Province
Dorset	Dorset
Doubs	Doubs
Dpto. Cajamarca	Dpto. Cajamarca
Drenthe	Drenthe
Dronning Maud Land	Dronning Maud Land
Dubrovacko-Neretvanska Zupanija	Dubrovacko-Neretvanska Zupanija
Duke of Kirk Island	Duke of Kirk Island
Duke of York Group	Duke of York Group
Duke of York Islands	Duke of York Islands
Duke of Yorke Islands	Duke of Yorke Islands
Dumyat	Dumyat
Dunedin	Dunedin
Durango	Durango
Durazno	Durazno
Durban	Durban
Durham	Durham
Dutch New Guinea	Dutch New Guinea
E High	E High
E Timor	E Timor
E. Transvaal Province	E. Transvaal Province
East Anglia	East Anglia
East Berbice-Corentyne Region	East Berbice-Corentyne Region
East China Sea	East China Sea
East Devon	East Devon
East European Russia	East European Russia
East Falklands	East Falklands
East Java	East Java
East Kalimantan	East Kalimantan
East London	East London
East Macedonia and Thrace	East Macedonia and Thrace
East Malaysia	East Malaysia
East Nepal	East Nepal
East New Britain	East New Britain
East New Britain D.	East New Britain D.
East New Britain District	East New Britain District
East New Britain Pro	East New Britain Pro
East New Britain Province	East New Britain Province
East Nusa Tengarra	East Nusa Tengarra
East Nusa Tenggara	East Nusa Tenggara
East Papua	East Papua
East Riding of Yorkshire	East Riding of Yorkshire
East Sepik	East Sepik
East Sepik District	East Sepik District
East Sepik Province	East Sepik Province
East Sussex	East Sussex
East Timor	East Timor
East Transvaal	East Transvaal
East java	East java
East kalimantan	East kalimantan
Easter Island	Easter Island
Easter island	Easter island
Eastern	Eastern
Eastern Cape	Eastern Cape
Eastern Cape Prov.	Eastern Cape Prov.
Eastern Cape Provenc	Eastern Cape Provenc
Eastern Cape Province	Eastern Cape Province
Eastern Division	Eastern Division
Eastern Highland Province	Eastern Highland Province
Eastern Highlands	Eastern Highlands
Eastern Highlands District	Eastern Highlands District
Eastern Highlands Province	Eastern Highlands Province
Eastern Holstein	Eastern Holstein
Eastern Nepal	Eastern Nepal
Eastern Province	Eastern Province
Eastern Region	Eastern Region
Eastern Samar	Eastern Samar
Eastern Sepik Province	Eastern Sepik Province
Eastern Sikkim district	Eastern Sikkim district
Eastern Visayas	Eastern Visayas
Eastern Wilkes Land	Eastern Wilkes Land
Eastern cape	Eastern cape
Edirne	Edirne
Edo Vera Cruz	Edo Vera Cruz
Edward VII Land	Edward VII Land
Efate	Efate
Egypt	Egypt
Ehime Prefecture	Ehime Prefecture
Ehime-ken	Ehime-ken
Ehine Prefecture	Ehine Prefecture
El Bayadh	El Bayadh
El Oro	El Oro
El Oued	El Oued
El Seibo	El Seibo
El Tarf	El Tarf
Elate Isl	Elate Isl
Elba	Elba
Emilia	Emilia
Emilia-Romagna	Emilia-Romagna
Enderby Land	Enderby Land
Enewetak Island	Enewetak Island
Eng	Eng
Enga	Enga
Enga Province	Enga Province
England	England
England/Surrey	England/Surrey
Eniwetok Island	Eniwetok Island
Enontekio Lapland	Enontekio Lapland
Entre Rios	Entre Rios
Enugu State	Enugu State
Epirus	Epirus
Equateur	Equateur
Erakor	Erakor
Erguy, Bretagne	Erguy, Bretagne
Eritrea	Eritrea
Ermera	Ermera
Ermera District	Ermera District
Erongo	Erongo
Erromanga Island	Erromanga Island
Erromango Island	Erromango Island
Esfahan	Esfahan
Esmeraldas	Esmeraldas
Espirito Santo	Espirito Santo
Espiritu Santo	Espiritu Santo
EspÔøΩrito Santo	EspÔøΩrito Santo
Essex	Essex
Estado Atlantico	Estado Atlantico
Estado Bolivar	Estado Bolivar
Estado Carabobo	Estado Carabobo
Estado Falcon	Estado Falcon
Estado Sao Paulo	Estado Sao Paulo
Estado Zulia	Estado Zulia
Esteli	Esteli
Estonia	Estonia
Estrecho de Magallanes	Estrecho de Magallanes
Estremadura	Estremadura
Estuaire	Estuaire
Etel√§-H√§me	Etel√§-H√§me
Etel√§-Karjala (South Karelia)	Etel√§-Karjala (South Karelia)
Etel√§-Savo (Southern Savonia)	Etel√§-Savo (Southern Savonia)
Etruria	Etruria
Eur	Eur
Euro	Euro
Europe	Europe
Euskal Autonomia Erkidegoa	Euskal Autonomia Erkidegoa
Exmoor	Exmoor
External Territories	External Territories
Extremadura	Extremadura
Exumas	Exumas
Eyre Penin.	Eyre Penin.
Faiyum Province	Faiyum Province
Fajardo	Fajardo
Falc?n	Falc?n
Falcon	Falcon
Falkland Islands	Falkland Islands
Falkland Islands Overseas Territory	Falkland Islands Overseas Territory
Falmouth	Falmouth
False Bay	False Bay
Far North Province	Far North Province
Farah	Farah
Farg`ona Viloyati	Farg`ona Viloyati
Faro	Faro
Fars	Fars
Feder	Feder
Federal	Federal
Federal Territory of Labuan	Federal Territory of Labuan
Federally Administered Northern Areas	Federally Administered Northern Areas
Federation of Bosnia and Herzegovina	Federation of Bosnia and Herzegovina
Fejer megye	Fejer megye
Fianarantsoa	Fianarantsoa
Fiji	Fiji
Fin	Fin
Finland	Finland
Finnmark	Finnmark
Finnmark Fylke	Finnmark Fylke
Firth	Firth
Flanders	Flanders
Flores	Flores
Florida	Florida
Florida Keys	Florida Keys
Fokien	Fokien
Foochow	Foochow
Forida	Forida
Formosa	Formosa
Fra	Fra
France	France
Franche-Comt√©	Franche-Comt√©
Francisco Morazan	Francisco Morazan
Franklin Is.	Franklin Is.
Free	Free
Free State	Free State
Free State Province	Free State Province
Freie und Hansestadt Hamburg	Freie und Hansestadt Hamburg
Freistaat Bayern	Freistaat Bayern
Freistaat Sachsen	Freistaat Sachsen
Freistaat Thuringen	Freistaat Thuringen
French Guiana	French Guiana
French Polynesia	French Polynesia
French Southern Territories	French Southern Territories
French Southern and Antarctic Lands	French Southern and Antarctic Lands
Fribourg	Fribourg
Friesland	Friesland
Friesland Province	Friesland Province
Friuli	Friuli
Friuli Venezia Giulia	Friuli Venezia Giulia
Friuli-Venezia Giulia	Friuli-Venezia Giulia
Frondhjem Fiord	Frondhjem Fiord
Frosinone	Frosinone
Fujian	Fujian
Fujian Sheng	Fujian Sheng
Fujien	Fujien
Fukui-ken	Fukui-ken
Fukuoka Prefecture	Fukuoka Prefecture
Fukuoka-ken	Fukuoka-ken
Fukushima	Fukushima
Fukushima Prefecture	Fukushima Prefecture
Fukushima-ken	Fukushima-ken
Funafuti	Funafuti
Fyn	Fyn
Gabes	Gabes
Gabrovo	Gabrovo
Gabu	Gabu
Gadji	Gadji
Gafsa	Gafsa
Gagnoa	Gagnoa
Galapagos	Galapagos
Galapagos Islands	Galapagos Islands
Galapagos Islands?	Galapagos Islands?
Galati	Galati
Galicia	Galicia
Galloway	Galloway
Galway	Galway
Gal√°pagos	Gal√°pagos
Gambia	Gambia
Ganca Sahari	Ganca Sahari
Gandaki	Gandaki
Gangwon-do	Gangwon-do
Gansu	Gansu
Gansu Sheng	Gansu Sheng
Gash Barka	Gash Barka
Gaudalcanal Province	Gaudalcanal Province
Gauteng	Gauteng
Gavleborgs Lan	Gavleborgs Lan
Gaza	Gaza
Gaza Strip	Gaza Strip
Gaziantep	Gaziantep
Gelderland	Gelderland
Geneve	Geneve
George V Land	George V Land
Georgia	Georgia
Ger	Ger
Germany	Germany
Gerona	Gerona
Geurrero	Geurrero
Ghanzi District	Ghanzi District
Ghardaia	Ghardaia
Gharda√Øa	Gharda√Øa
Ghorakpur Division	Ghorakpur Division
Gia Lai	Gia Lai
Gibraltar	Gibraltar
Gifu Prefecture	Gifu Prefecture
Gifu-ken	Gifu-ken
Gilan	Gilan
Gilbert Islands District	Gilbert Islands District
Gironde	Gironde
Gisborne	Gisborne
Gisborne Land District	Gisborne Land District
Giurgiu	Giurgiu
Giza	Giza
Glarus	Glarus
Gloucester	Gloucester
Goa	Goa
Goa State	Goa State
Gobabis	Gobabis
Goias	Goias
Goi√°s	Goi√°s
Golestan	Golestan
Gonubie	Gonubie
Goodhouse District	Goodhouse District
Gorj	Gorj
Gorontalo	Gorontalo
Goteborg	Goteborg
Gotland	Gotland
Gotlands Lan	Gotlands Lan
Goudier Islet	Goudier Islet
Gough Island	Gough Island
Gouvernorat de Bizerte	Gouvernorat de Bizerte
Gouvernorat de Kasserine	Gouvernorat de Kasserine
Gouvernorat de Kebili	Gouvernorat de Kebili
Gouvernorat de Mahdia	Gouvernorat de Mahdia
Gouvernorat de Medenine	Gouvernorat de Medenine
Gouvernorat de Sidi Bou Zid	Gouvernorat de Sidi Bou Zid
Gouvernorat de Siliana	Gouvernorat de Siliana
Govi-Altay Aymag	Govi-Altay Aymag
Govt. Santa Cruz	Govt. Santa Cruz
Goycay Rayonu	Goycay Rayonu
Grad Zagreb	Grad Zagreb
Grampians	Grampians
Granada	Granada
Granada Province	Granada Province
Grand Casablanca	Grand Casablanca
Grand Est	Grand Est
Grand Terre, Province Nord	Grand Terre, Province Nord
Grand Terre, Province Sud	Grand Terre, Province Sud
Grand'Anse	Grand'Anse
Granma	Granma
Graubunden	Graubunden
Graub√ºnden	Graub√ºnden
Greater Accra	Greater Accra
Greater Accra Region	Greater Accra Region
Greater Antilles	Greater Antilles
Greater London	Greater London
Greece	Greece
Greenland	Greenland
Grevenmacher	Grevenmacher
Grootfontein	Grootfontein
Gua	Gua
Guadacanal	Guadacanal
Guadal	Guadal
Guadalajara	Guadalajara
Guadalcanal	Guadalcanal
Guadalcanal Is	Guadalcanal Is
Guadalcanal Province	Guadalcanal Province
Guadeloupe	Guadeloupe
Guaira	Guaira
Guam	Guam
Guanacaste	Guanacaste
Guanacaste Province	Guanacaste Province
Guanajuato	Guanajuato
GuangXi	GuangXi
Guangdong	Guangdong
Guangdong Province	Guangdong Province
Guangdong Sheng	Guangdong Sheng
Guangxi	Guangxi
Guangxi Province	Guangxi Province
Guangxi Zhuangzu Zizhiqu	Guangxi Zhuangzu Zizhiqu
Guantanamo	Guantanamo
Guarda	Guarda
Guarico	Guarico
Guatemala	Guatemala
Guatmas	Guatmas
Guayama District	Guayama District
Guayas	Guayas
Guaymas	Guaymas
Guaymas Mazatl√°n	Guaymas Mazatl√°n
Guelma	Guelma
Guemueshane	Guemueshane
Guernsey	Guernsey
Guerrero	Guerrero
Guerrero State	Guerrero State
Guimaras Island	Guimaras Island
Guimaras Province	Guimaras Province
Guizhou	Guizhou
Guizhou Province	Guizhou Province
Guizhou Sheng	Guizhou Sheng
Gujarat	Gujarat
Gujurat State	Gujurat State
Gulf	Gulf
Gulf District	Gulf District
Gulf Province	Gulf Province
Gulf of California	Gulf of California
Gulf of Mexico	Gulf of Mexico
Gumma-ken	Gumma-ken
Guyana	Guyana
Guyane	Guyane
Gyeneonggi-do	Gyeneonggi-do
Gyeonggi-do	Gyeonggi-do
Gyeongsanbuk-do	Gyeongsanbuk-do
Gyeongsangnam-do	Gyeongsangnam-do
Gyor-Moson-Sopron megye	Gyor-Moson-Sopron megye
G√§strikland	G√§strikland
Ha	Ha
Ha Tay	Ha Tay
Ha Tinh	Ha Tinh
Ha'apai Group	Ha'apai Group
Haa Dzongkhag	Haa Dzongkhag
Habana	Habana
Hadramaut	Hadramaut
Hai Duong	Hai Duong
Hai Phong	Hai Phong
Hai-Lang	Hai-Lang
Haifa	Haifa
Haifa District	Haifa District
Hainan	Hainan
Hainan Dao	Hainan Dao
Hainan Sheng	Hainan Sheng
Hainaut	Hainaut
Hajdu-Bihar megye	Hajdu-Bihar megye
Halab	Halab
Halland	Halland
Halland County	Halland County
Hallands Lan	Hallands Lan
Halmahera	Halmahera
Hamburg	Hamburg
Hanoi	Hanoi
Hants.	Hants.
Harare District	Harare District
Harare Province	Harare Province
Hardap	Hardap
Harghita	Harghita
Haryana	Haryana
Hatay	Hatay
Haut-Ogooue	Haut-Ogooue
Haut-Ogoou√©	Haut-Ogoou√©
Haute Matsiatra	Haute Matsiatra
Haute Savoie	Haute Savoie
Haute-Garonne	Haute-Garonne
Haute-Savoie	Haute-Savoie
Hauts-de-France	Hauts-de-France
Havana	Havana
Havant	Havant
Hawaii	Hawaii
Hawaii Honolulu	Hawaii Honolulu
Hawaii.	Hawaii.
Hawaiian Islands	Hawaiian Islands
Hawke's Bay	Hawke's Bay
Hawke's Bay Land District	Hawke's Bay Land District
Heard Island	Heard Island
Heard Island and McDonald Island	Heard Island and McDonald Island
Heard Island and McDonald Islands	Heard Island and McDonald Islands
Heard Island.	Heard Island.
Heard and McDonald Islands	Heard and McDonald Islands
Hebei Province	Hebei Province
Hebei Sheng	Hebei Sheng
Hedmark	Hedmark
Hedmark Fylke	Hedmark Fylke
HeiLongJang	HeiLongJang
Heilongjiang	Heilongjiang
Heilongjiang Sheng	Heilongjiang Sheng
Heilungkiang	Heilungkiang
Hela Province	Hela Province
Henan Sheng	Henan Sheng
Henderson Island	Henderson Island
Herat	Herat
Herault	Herault
Herceg-Novi	Herceg-Novi
Hercegovina	Hercegovina
Heredia	Heredia
Heredia Province	Heredia Province
Herrera	Herrera
Hertfordshire	Hertfordshire
Hesse	Hesse
Hesse (Hessen)	Hesse (Hessen)
Hessen	Hessen
Heves megye	Heves megye
Hhohho District	Hhohho District
Hidalgo	Hidalgo
Hideaway Island	Hideaway Island
Hiiumaa County	Hiiumaa County
Hildago	Hildago
Himachal Pradesh	Himachal Pradesh
Hincesti	Hincesti
Hindustan	Hindustan
Hiroshima	Hiroshima
Hiroshima Pref.	Hiroshima Pref.
Hizen	Hizen
Hlavni mesto Praha	Hlavni mesto Praha
Hlavn√≠ mesto Praha	Hlavn√≠ mesto Praha
Ho Chi Minh City	Ho Chi Minh City
Hoa Binh	Hoa Binh
Hokkaido	Hokkaido
Hokkaido Prefecture	Hokkaido Prefecture
Hol	Hol
Holguin	Holguin
Holland	Holland
Homyel'skaya Voblasts'	Homyel'skaya Voblasts'
Hondo	Hondo
Hong Kong	Hong Kong
Honolulu	Honolulu
Honshu	Honshu
Hordaland	Hordaland
Hordaland Fylke	Hordaland Fylke
Houaphanh	Houaphanh
Hovedstaden	Hovedstaden
Hovsgol Aymag	Hovsgol Aymag
Hrodzyenskaya Voblasts'	Hrodzyenskaya Voblasts'
Hrpelje-Kozina	Hrpelje-Kozina
Hsinchu	Hsinchu
Hua-lien Hsien	Hua-lien Hsien
Huahine	Huahine
Hualien	Hualien
Huambo	Huambo
Huanuco	Huanuco
Hubei	Hubei
Hubei Sheng	Hubei Sheng
Hudaydah	Hudaydah
Huehuetenango	Huehuetenango
Huesca	Huesca
Huila	Huila
Huila Province	Huila Province
Humacao District	Humacao District
Humewood	Humewood
Hunan	Hunan
Hunan Province	Hunan Province
Hunan Sheng	Hunan Sheng
Hunedoara	Hunedoara
Hung Yen	Hung Yen
Huntingdonshire	Huntingdonshire
Huon Peninsula	Huon Peninsula
Hu√°nuco	Hu√°nuco
Hyogo Pref.	Hyogo Pref.
Hyogo Prefecture	Hyogo Prefecture
Hyogo-ken	Hyogo-ken
H√§lsingland Prov.	H√§lsingland Prov.
H√§rjedalen	H√§rjedalen
H√§rjedalen Prov.	H√§rjedalen Prov.
H√©rault d√©partement	H√©rault d√©partement
I-lan Hsien	I-lan Hsien
Iasi	Iasi
Ibaraki Pref.	Ibaraki Pref.
Ibaraki Prefecture	Ibaraki Prefecture
Ica	Ica
Ice	Ice
Icel	Icel
Ida-Virumaa County	Ida-Virumaa County
Idaho	Idaho
Idrija	Idrija
Ifugao	Ifugao
Igdir	Igdir
Iii	Iii
Ile Nouvelle Amsterdam	Ile Nouvelle Amsterdam
Ile des Pins	Ile des Pins
Ile-de-France	Ile-de-France
Iles Amsterdam & St Paul	Iles Amsterdam & St Paul
Iles Crozet	Iles Crozet
Iles Crozet total	Iles Crozet total
Iles Kerguelen	Iles Kerguelen
Ilfov	Ilfov
Ilirska Bistrica	Ilirska Bistrica
Illes Balears	Illes Balears
Illinois	Illinois
Ilocos Norte	Ilocos Norte
Ilocos Sur	Ilocos Sur
Iloilo	Iloilo
Iloilo province	Iloilo province
Imbabura	Imbabura
Imo State	Imo State
Inari	Inari
Indian Ocean	Indian Ocean
Indiana	Indiana
Indo	Indo
Indop	Indop
Inhambane	Inhambane
Inhambane Province	Inhambane Province
Inner Mongolia	Inner Mongolia
Inner Mongolia Autonomous Region	Inner Mongolia Autonomous Region
Ionian Islands	Ionian Islands
Iowa	Iowa
Iquique Province	Iquique Province
Irian Jaya	Irian Jaya
Irian Jaya Barat	Irian Jaya Barat
Irian jaya	Irian jaya
Iringa	Iringa
Iringa Region	Iringa Region
Irkutskaya Oblast'	Irkutskaya Oblast'
Isabel	Isabel
Isabel Province	Isabel Province
Isabel province	Isabel province
Isabela	Isabela
Ishikawa Prefecture	Ishikawa Prefecture
Ishikawa-ken	Ishikawa-ken
Iskandariyah	Iskandariyah
Isla Margarita	Isla Margarita
Isla de Tenerife	Isla de Tenerife
Isla de los Estados	Isla de los Estados
Isla del Cocos	Isla del Cocos
Islamabad Capital Territory	Islamabad Capital Territory
Island of Shikoku	Island of Shikoku
Islas Malvinas	Islas Malvinas
Isle of Man	Isle of Man
Isle of man	Isle of man
Isma`iliyah	Isma`iliyah
Istanbul	Istanbul
Istarska Zupanija	Istarska Zupanija
Istimewa Aceh	Istimewa Aceh
Istimewa Yogyakarta	Istimewa Yogyakarta
Itae-Suomen Laeaeni	Itae-Suomen Laeaeni
Itapua	Itapua
Ituri	Ituri
Iwate Prefecture	Iwate Prefecture
Iwate-ken	Iwate-ken
Izabal	Izabal
Izmir	Izmir
Izola-Isola	Izola-Isola
Jaen	Jaen
Jakarta	Jakarta
Jalal-Abad Oblasty	Jalal-Abad Oblasty
Jalisco	Jalisco
Jalisco State	Jalisco State
Jambi	Jambi
Jammu and Kashmir	Jammu and Kashmir
Jamtlands Lan	Jamtlands Lan
Janub Kurdufan	Janub Kurdufan
Janub Sina'	Janub Sina'
Jasz-Nagykun-Szolnok megye	Jasz-Nagykun-Szolnok megye
Java	Java
Jawa	Jawa
Jawa Barat	Jawa Barat
Jawa Tengah	Jawa Tengah
Jawa Timur	Jawa Timur
Jeddah Coast	Jeddah Coast
Jeffery's Bay	Jeffery's Bay
Jeju-do	Jeju-do
Jendouba	Jendouba
Jeollabuk-do	Jeollabuk-do
Jeollanam-do	Jeollanam-do
Jersey	Jersey
Jerusalem District	Jerusalem District
Jesenice	Jesenice
Jharkhand	Jharkhand
Jia	Jia
Jiangsu	Jiangsu
Jiangsu Sheng	Jiangsu Sheng
Jiangxi	Jiangxi
Jiangxi Province	Jiangxi Province
Jiangxi Sang	Jiangxi Sang
Jiangxi Sheng	Jiangxi Sheng
Jihocesky Kraj	Jihocesky Kraj
Jihomoravsky kraj	Jihomoravsky kraj
Jinotega	Jinotega
Jiwaka Province	Jiwaka Province
Jizzakh	Jizzakh
Jizzax Viloyati	Jizzax Viloyati
Johor	Johor
Johore	Johore
Jonglei	Jonglei
Jonkopings Lan	Jonkopings Lan
Juan Fernandez Islands	Juan Fernandez Islands
Jubbada Hoose	Jubbada Hoose
Jujuy	Jujuy
Jujuy Province	Jujuy Province
Junggok-dong	Junggok-dong
Junin	Junin
Junin Region	Junin Region
Jura	Jura
J√§mtland	J√§mtland
J√§mtland County	J√§mtland County
K'aghak' Yerevan	K'aghak' Yerevan
K'alak'i T'bilisi	K'alak'i T'bilisi
Kabaena Island	Kabaena Island
Kabol	Kabol
Kachin	Kachin
Kachin State	Kachin State
Kadavu	Kadavu
Kadavu Province	Kadavu Province
Kaduna State	Kaduna State
Kaernten	Kaernten
Kagawa-ken	Kagawa-ken
Kagoshima	Kagoshima
Kagoshima Pref.	Kagoshima Pref.
Kagoshima Prefecture	Kagoshima Prefecture
Kagoshima-ken	Kagoshima-ken
Kahramanmaras	Kahramanmaras
Kainuu Region	Kainuu Region
Kairouan	Kairouan
Kajiado County	Kajiado County
Kakamega County	Kakamega County
Kalewa	Kalewa
Kalimantan	Kalimantan
Kalimantan Barat	Kalimantan Barat
Kalimantan Selatan	Kalimantan Selatan
Kalimantan Timur	Kalimantan Timur
Kalimantan Utara	Kalimantan Utara
Kalimantan selatan	Kalimantan selatan
Kalimantan timor	Kalimantan timor
Kaliningradskaya Oblast'	Kaliningradskaya Oblast'
Kalmar	Kalmar
Kalmar County	Kalmar County
Kalmar Lan	Kalmar Lan
Kamchatskaya Oblast'	Kamchatskaya Oblast'
Kamnik	Kamnik
Kampong Cham	Kampong Cham
Kampong Chhnang	Kampong Chhnang
Kampong Chhnang Province	Kampong Chhnang Province
Kampong Thom	Kampong Thom
Kampot	Kampot
Kanagawa Pref.	Kanagawa Pref.
Kanagawa Prefect	Kanagawa Prefect
Kanagawa Prefecture	Kanagawa Prefecture
Kanagawa-ken	Kanagawa-ken
Kanchanaburi	Kanchanaburi
Kandrian	Kandrian
Kangwon	Kangwon
Kangwon Province	Kangwon Province
Kanh Hoa Prov.	Kanh Hoa Province
Kano State	Kano State
Kansas	Kansas
Kanto	Kanto
Kaokoveld	Kaokoveld
Karabuek	Karabuek
Karas	Karas
Karelia borealis	Karelia borealis
Karelian Isthmus	Karelian Isthmus
Kareliya	Kareliya
Karlovacka Zupanija	Karlovacka Zupanija
Karlovarsky kraj	Karlovarsky kraj
Karnali	Karnali
Karnataka	Karnataka
Karnataka State	Karnataka State
Karonga District	Karonga District
Kashmir	Kashmir
Kassala	Kassala
Katanga	Katanga
Kavango	Kavango
Kayah State	Kayah State
Kayes	Kayes
Kayes Region	Kayes Region
Kayin	Kayin
Kebili	Kebili
Kedah	Kedah
Kedah state	Kedah state
Kef	Kef
Kelantan	Kelantan
Kemerovskaya Oblast'	Kemerovskaya Oblast'
Kemp Land	Kemp Land
Kent	Kent
Kentucky	Kentucky
Kenya	Kenya
Kepulauan Bangka Belitung	Kepulauan Bangka Belitung
Kerala	Kerala
Kerguelen	Kerguelen
Kerguelen Is.	Kerguelen Is.
Kerguelen Island	Kerguelen Island
Kerguelen Islands	Kerguelen Islands
Kerguelen Islands Territory	Kerguelen Islands Territory
Kermadec Group	Kermadec Group
Kermadec Isalnds	Kermadec Isalnds
Kermadec Islands	Kermadec Islands
Kermadecs	Kermadecs
Kerman	Kerman
Kgatleng District	Kgatleng District
Khabarovskiy Kray	Khabarovskiy Kray
Khakasiya	Khakasiya
Khammouan Prov	Khammouan Prov
Khammouane	Khammouane
Khammouane Province	Khammouane Province
Khanh Hoa	Khanh Hoa
Kharkivs'ka Oblast'	Kharkivs'ka Oblast'
Khartoum Province	Khartoum Province
Khaskovo	Khaskovo
Khatlon	Khatlon
Khayelitsha	Khayelitsha
Khersons'ka Oblast'	Khersons'ka Oblast'
Khet Siemreab-Otar Meanchey	Khet Siemreab-Otar Meanchey
Khett Kampong Chhnang	Khett Kampong Chhnang
Khett Kampong Spoe	Khett Kampong Spoe
Khett Kampot	Khett Kampot
Khett Preah Vihear	Khett Preah Vihear
Khett Rotanokiri	Khett Rotanokiri
Khomas	Khomas
Khon Kaen	Khon Kaen
Khorasan-e Jonubi	Khorasan-e Jonubi
Khorasan-e Razavi	Khorasan-e Razavi
Khorezm	Khorezm
Khulna Division	Khulna Division
Khusus Ibukota Jakarta Raya	Khusus Ibukota Jakarta Raya
Khuzestan	Khuzestan
Kiangsu	Kiangsu
Kien Giang	Kien Giang
Kiev Oblast	Kiev Oblast
Kiew	Kiew
Kildare	Kildare
Kilifi	Kilifi
Kilifi County	Kilifi County
Kilimanjaro	Kilimanjaro
Kilimanjaro Region	Kilimanjaro Region
Kimbe	Kimbe
King George V Land	King George V Land
Kingston	Kingston
Kiribati	Kiribati
Kirovohrads'ka Oblast'	Kirovohrads'ka Oblast'
Kitava Island	Kitava Island
Kitui	Kitui
Kiushiu	Kiushiu
Kivu	Kivu
Kleinmond	Kleinmond
Kocevje	Kocevje
Kochi	Kochi
Kochi Pref.	Kochi Pref.
Kochi Prefectur	Kochi Prefectur
Kochi Prefecture	Kochi Prefecture
Kochi-ken	Kochi-ken
Koh Kong	Koh Kong
Kolombangara	Kolombangara
Komarom-Esztergom megye	Komarom-Esztergom megye
Komen	Komen
Komi	Komi
Kon Tum	Kon Tum
Kon Tum Province	Kon Tum Province
Konya	Konya
Koper-Capodistria	Koper-Capodistria
Koprivnicko-Krizevacka Zupanija	Koprivnicko-Krizevacka Zupanija
Kordestan	Kordestan
Korea	Korea
Koror State	Koror State
Korup	Korup
Kosi	Kosi
Kosicky Kraj	Kosicky Kraj
Kosovo	Kosovo
Kosrae	Kosrae
Kosrae State	Kosrae State
Kostanayskaya Oblast'	Kostanayskaya Oblast'
Kostel	Kostel
Kostromskaya Oblast'	Kostromskaya Oblast'
Kotayk'i Marz	Kotayk'i Marz
Kotor	Kotor
Koulikoro	Koulikoro
Kowie	Kowie
Krabi Province	Krabi Province
Kraj Vysocina	Kraj Vysocina
Krakatau	Krakatau
Krakatau Island	Krakatau Island
Krakatau Islands	Krakatau Islands
Kralovehradecky kraj	Kralovehradecky kraj
Kranj	Kranj
Kranjska Gora	Kranjska Gora
Krasnodarskiy Kray	Krasnodarskiy Kray
Krasnoyarsk Krai	Krasnoyarsk Krai
Krasnoyarskiy Kray	Krasnoyarskiy Kray
Krong Phnum Penh	Krong Phnum Penh
Kronobergs Lan	Kronobergs Lan
Kuala Lumpur	Kuala Lumpur
Kujawsko-Pomorskie	Kujawsko-Pomorskie
Kumamoto Pref.	Kumamoto Pref.
Kumamoto-ken	Kumamoto-ken
Kuna Yala	Kuna Yala
Kunene	Kunene
Kurachi	Kurachi
Kurdzhali	Kurdzhali
Kurganskaya Oblast'	Kurganskaya Oblast'
Kuroda	Kuroda
Kuwait	Kuwait
KwaZulu Natal	KwaZulu Natal
KwaZulu-Natal	KwaZulu-Natal
KwaZulu-Natal Prov.	KwaZulu-Natal Prov.
KwaZulu-Natal Province	KwaZulu-Natal Province
Kwale County	Kwale County
Kwangtung	Kwangtung
Kwara State	Kwara State
Kwazulu-Natal	Kwazulu-Natal
Kyonggi	Kyonggi
Kyongsang-namdo	Kyongsang-namdo
Kyoto Prefecture	Kyoto Prefecture
Kyoto-fu	Kyoto-fu
Kyushi	Kyushi
Kyushu	Kyushu
Kyushu Region	Kyushu Region
Kyushu, Kagoshima Prefecture	Kyushu, Kagoshima Prefecture
Kyustendil	Kyustendil
Kyyivs'ka Oblast'	Kyyivs'ka Oblast'
K√§rnten	K√§rnten
K√ºtahya Province	K√ºtahya Province
K≈çchi Prefecture	K≈çchi Prefecture
L'vivs'ka Oblast'	L'vivs'ka Oblast'
La Araucania	La Araucania
La Coruna	La Coruna
La Guayra	La Guayra
La Habana	La Habana
La Pampa	La Pampa
La Paz	La Paz
La Paz Department	La Paz Department
La Rioja	La Rioja
La Union	La Union
La Vega	La Vega
Laayoune-Boujdour-Sakia El Hamra	Laayoune-Boujdour-Sakia El Hamra
Labrador	Labrador
Labuan	Labuan
Labuan Island	Labuan Island
Laghouat	Laghouat
Lagos	Lagos
Lagos State	Lagos State
Laguna	Laguna
Laguna Province	Laguna Province
Lagunes	Lagunes
Lai Chau	Lai Chau
Lakes	Lakes
Lakshadweep	Lakshadweep
Lam Dong	Lam Dong
Lam Dong Province	Lam Dong Province
Lampang	Lampang
Lampang Province	Lampang Province
Lamphun	Lamphun
Lampung	Lampung
Lanao Sur	Lanao Sur
Lancashire	Lancashire
Lang Son Province	Lang Son Province
Langeton Logoon	Langeton Logoon
Languedoc-Roussillon	Languedoc-Roussillon
Lankaran Rayon	Lankaran Rayon
Lankaran Rayonu	Lankaran Rayonu
Lankaran Sahari	Lankaran Sahari
Lankashire	Lankashire
Lao Cai	Lao Cai
Lao Cai Province	Lao Cai Province
Lapland	Lapland
Lappi (Lapland)	Lappi (Lapland)
Lappland	Lappland
Lara	Lara
Larnaca District	Larnaca District
Larnaka	Larnaka
Las Palmas,	Las Palmas,
Lau Islands	Lau Islands
Lautem	Lautem
Lautem District	Lautem District
LautÔøΩm	LautÔøΩm
Laxardalur	Laxardalur
Laziale	Laziale
Lazio	Lazio
Lazio Province	Lazio Province
LeCroisic	LeCroisic
Lebanon	Lebanon
Lebap Welayaty	Lebap Welayaty
Lecce Province	Lecce Province
Lefkosia (Nicosia)	Lefkosia (Nicosia)
Leibo County	Leibo County
Leicestershire	Leicestershire
Leinster	Leinster
Lempira	Lempira
Leningrad Oblast	Leningrad Oblast
Leningradskaya Oblast'	Leningradskaya Oblast'
Leribe	Leribe
Leribe District	Leribe District
Lerik Rayonu	Lerik Rayonu
Les Mamelles	Les Mamelles
Lesotho	Lesotho
Lesser Poland	Lesser Poland
Lesser Sunda Islands	Lesser Sunda Islands
Lesser Voivodeship	Lesser Voivodeship
Leyte	Leyte
Leyte Prov.	Leyte Prov.
Leyte province	Leyte province
LeÔøΩn	LeÔøΩn
Lhuentse Dzongkhag	Lhuentse Dzongkhag
Liaoning	Liaoning
Liaoning Province	Liaoning Province
Liban-Nord	Liban-Nord
Liban-Sud	Liban-Sud
Liberecky kraj	Liberecky kraj
Libertador General Bernardo O'Higgins	Libertador General Bernardo O'Higgins
Libya	Libya
Licko-Senjska Zupanija	Licko-Senjska Zupanija
Liege	Liege
Liguria	Liguria
Lihou Reef	Lihou Reef
Lilongwe District	Lilongwe District
Lima	Lima
Lima Province	Lima Province
Limar√≠	Limar√≠
Limasol	Limasol
Limassol	Limassol
Limassol District	Limassol District
Limberg	Limberg
Limburg	Limburg
Limon	Limon
Limon Province	Limon Province
Limousin	Limousin
Limpopo	Limpopo
Limpopo Province	Limpopo Province
Lim√≥n	Lim√≥n
Lincolnshire	Lincolnshire
Lindi Region	Lindi Region
Liquica	Liquica
Liquica District	Liquica District
Lisboa	Lisboa
Lisbon	Lisbon
Little Karoo	Little Karoo
Livourne	Livourne
Ljubljana	Ljubljana
Llanquihue	Llanquihue
Llanquihue Province	Llanquihue Province
Lobaye	Lobaye
Loei	Loei
Loire-Atlantique Department	Loire-Atlantique Department
Loja	Loja
Lombardia	Lombardia
Lombardy	Lombardy
Lombok	Lombok
London	London
Longzhou County	Longzhou County
Lop Buri	Lop Buri
Lopburi	Lopburi
Lord Howe Island	Lord Howe Island
Lord Howe Island?	Lord Howe Island?
Loreto	Loreto
Loreto Province	Loreto Province
Los Lagos	Los Lagos
Los Negros	Los Negros
Los Rios	Los Rios
Los R√≠os	Los R√≠os
Los Santos	Los Santos
Los Santos Province	Los Santos Province
Lothian	Lothian
Louangphrabang	Louangphrabang
Louisana	Louisana
Louisiade Archipelago	Louisiade Archipelago
Louisiana	Louisiana
Lovech	Lovech
Lower Austria	Lower Austria
Lower Saxony	Lower Saxony
Loyalty Is.	Loyalty Is.
Loyalty Island	Loyalty Island
Loyalty Island Coral Sea	Loyalty Island Coral Sea
Loyalty Islands	Loyalty Islands
Loyalty Islands Province	Loyalty Islands Province
Luanda	Luanda
Luang Namtha	Luang Namtha
Luang Numtha	Luang Numtha
Luang Prabang	Luang Prabang
Luang Prabang Province	Luang Prabang Province
Luangwa District	Luangwa District
Luapula Province	Luapula Province
Lubelskie	Lubelskie
Lubombo District	Lubombo District
Lubuskie	Lubuskie
Lunda Sul	Lunda Sul
Luogo	Luogo
Lusaka Province	Lusaka Province
Luxembourg	Luxembourg
Luzern	Luzern
Luzon	Luzon
Luzon Island	Luzon Island
Luzon, West Quezon Province	Luzon, West Quezon Province
Ma'akel	Ma'akel
Mac. Robertson Land	Mac. Robertson Land
Mac.Robertson Land	Mac.Robertson Land
MacRobertson Land	MacRobertson Land
Macau	Macau
Macedonia	Macedonia
Machinga District	Machinga District
Macquarie Island	Macquarie Island
Mactan Island	Mactan Island
Madang	Madang
Madang District	Madang District
Madang Province	Madang Province
Madeira	Madeira
Madeira Island	Madeira Island
Madeira Islands	Madeira Islands
Madhya Pradesh	Madhya Pradesh
Madinah	Madinah
Madras	Madras
Madre de Dios	Madre de Dios
Madrid	Madrid
Madriz	Madriz
Mae Hong Son Province	Mae Hong Son Province
Mafeteng District	Mafeteng District
Magadanskaya Oblast'	Magadanskaya Oblast'
Magall. & Antarctica	Magall. & Antarctica
Magallanes	Magallanes
Magallanes Province	Magallanes Province
Magallanes y de Ant√°rtica Chilena	Magallanes y de Ant√°rtica Chilena
Magallenes	Magallenes
Magdalena	Magdalena
Magellanes	Magellanes
Magellanes Prov.	Magellanes Prov.
Magway Division	Magway Division
Mahajanga	Mahajanga
Maharashtra	Maharashtra
Mahdia	Mahdia
Mahe	Mahe
Mahilyowskaya Voblasts'	Mahilyowskaya Voblasts'
Maine	Maine
Maio	Maio
Majuro Atoll	Majuro Atoll
Makira	Makira
Makira Province	Makira Province
Makira province	Makira province
Makira-Ulawa	Makira-Ulawa
Makira-Ulawa Province	Makira-Ulawa Province
Makira-ulawa Province	Makira-ulawa Province
Makkah	Makkah
Makueni County	Makueni County
Malacca	Malacca
Malaga	Malaga
Malagasy Republic	Malagasy Republic
Malaita	Malaita
Malaita Island	Malaita Island
Malaita Province	Malaita Province
Malaku	Malaku
Malampa	Malampa
Malampa Province	Malampa Province
Malanje	Malanje
Malanje Province	Malanje Province
Malawi	Malawi
Malay Peninsula	Malay Peninsula
Malaya	Malaya
Malaysia	Malaysia
Maldonado	Maldonado
Malekula	Malekula
Malekula Island	Malekula Island
Malesia	Malesia
Malindi District	Malindi District
Malleco	Malleco
Malleco Province	Malleco Province
Mallorca	Mallorca
Malo Island	Malo Island
Malopolskie	Malopolskie
Malta	Malta
Maluku	Maluku
Maluku Province	Maluku Province
Maluku Province: Seram	Maluku Province: Seram
Maluku Utara	Maluku Utara
Maluku province	Maluku province
Manabi	Manabi
Manatuto	Manatuto
Manatuto District	Manatuto District
Manawatu-Wanganui	Manawatu-Wanganui
Manchester	Manchester
Manchuria	Manchuria
Mandalay	Mandalay
Mandalay Division	Mandalay Division
Mandora	Mandora
Mangalore	Mangalore
Mangochi District	Mangochi District
Manica	Manica
Manica e Sofala	Manica e Sofala
Manicaland	Manicaland
Manicaland Province	Manicaland Province
Maniema	Maniema
Manihiki	Manihiki
Manila	Manila
Manila metro	Manila metro
Manipur	Manipur
Manipur State	Manipur State
Manisa	Manisa
Manitoba	Manitoba
Manufahi	Manufahi
Manufahi District	Manufahi District
Manukau	Manukau
Manus	Manus
Manus District	Manus District
Manus Island	Manus Island
Manus Province	Manus Province
Manyara	Manyara
Manzanilla	Manzanilla
Manzini District	Manzini District
Maputo	Maputo
Mara Region	Mara Region
Marahoue	Marahoue
Maramures	Maramures
Maranhao	Maranhao
Marche	Marche
Mardin	Mardin
Maria Trinidad Sanchez	Maria Trinidad Sanchez
Mariana Islands	Mariana Islands
Marie Byrd Land	Marie Byrd Land
Marinduque Island	Marinduque Island
Marion Island	Marion Island
Marlborough	Marlborough
Marlborough Land District	Marlborough Land District
Marquesas	Marquesas
Marquesas Islands	Marquesas Islands
Marrakech	Marrakech
Marrakech-Tensift-Al Haouz	Marrakech-Tensift-Al Haouz
Marseille	Marseille
Marshall Islands	Marshall Islands
Martinique	Martinique
Mary Welayaty	Mary Welayaty
Maryland	Maryland
Masalli Rayonu	Masalli Rayonu
Masbate	Masbate
Masbate Province	Masbate Province
Mascara	Mascara
Mascarene Islands	Mascarene Islands
Maseru District	Maseru District
Mashonaland Central	Mashonaland Central
Mashonaland Central Province	Mashonaland Central Province
Mashonaland East Province	Mashonaland East Province
Mashonaland West	Mashonaland West
Mashonaland West Province	Mashonaland West Province
Masindi	Masindi
Mass	Mass
Massachetts	Massachetts
Massachusetts	Massachusetts
Massachussets	Massachussets
Massachussetts	Massachussetts
Masvingo	Masvingo
Masvingo Province	Masvingo Province
Matabeleland North	Matabeleland North
Matabeleland North Province	Matabeleland North Province
Matabeleland South Province	Matabeleland South Province
Matagalpa	Matagalpa
Matakana	Matakana
Matanzas	Matanzas
Matanzas Province	Matanzas Province
Mato Grosso	Mato Grosso
Mato Grosso do Sul	Mato Grosso do Sul
Matruh	Matruh
Matto Grosso	Matto Grosso
Matto Grosso do Sul	Matto Grosso do Sul
Maug	Maug
Maule	Maule
Mauritius	Mauritius
Mauritius / Philippines	Mauritius / Philippines
Mayabeque Province	Mayabeque Province
Mayag√ºez District	Mayag√ºez District
Mayor Island	Mayor Island
Mayotte	Mayotte
Mazatlan	Mazatlan
Mazowieckie	Mazowieckie
Mbd	Mbd
Mbeya	Mbeya
Mbeya District	Mbeya District
Mbibi District	Mbibi District
Mbomou	Mbomou
Mbour	Mbour
Mbulia Island	Mbulia Island
McDonald Islands	McDonald Islands
Mecklenburg	Mecklenburg
Mecklenburg-Vorpomm.	Mecklenburg-Vorpomm.
Mecklenburg-Vorpommern	Mecklenburg-Vorpommern
Medea	Medea
Medelpad	Medelpad
Medenine	Medenine
Mediterranean	Mediterranean
Meghalaya	Meghalaya
Mehedinti	Mehedinti
Mehedinti Co.	Mehedinti Co.
Mehedinti County	Mehedinti County
Meknes-Tafilalet	Meknes-Tafilalet
Melaka	Melaka
Melan	Melan
Melanesia	Melanesia
Mendoza	Mendoza
Merida	Merida
Merseyside	Merseyside
Mersin Province	Mersin Province
Meru	Meru
Meta	Meta
Metro Manila	Metro Manila
Metropolitan Manila	Metropolitan Manila
Metropolitana de Santiago	Metropolitana de Santiago
Mexic	Mexic
Mexico	Mexico
Mexico City	Mexico City
Miao-li Hsien	Miao-li Hsien
Miaoli Hsien	Miaoli Hsien
Michigan	Michigan
Michoacan	Michoacan
Michoacan de Ocampo	Michoacan de Ocampo
Micro	Micro
Micronesia	Micronesia
Middle East	Middle East
Middlesex	Middlesex
Midi-Pyrenees	Midi-Pyrenees
Midlands Province	Midlands Province
Midtjylland	Midtjylland
Mie Pref.	Mie Pref.
Mie Prefecture	Mie Prefecture
Milne B	Milne B
Milne Bay	Milne Bay
Milne Bay District	Milne Bay District
Milne Bay Provence	Milne Bay Provence
Milne Bay Province	Milne Bay Province
Mimaropa	Mimaropa
Minas	Minas
Minas Geraes	Minas Geraes
Minas Gerais	Minas Gerais
Mindanao	Mindanao
Mindanao Island	Mindanao Island
Mindanoa Island	Mindanoa Island
Mindora Island	Mindora Island
Mindoro	Mindoro
Mindoro Island	Mindoro Island
Mindoro Occidental	Mindoro Occidental
Mindoro Oriental	Mindoro Oriental
Minn	Minn
Minneapolis	Minneapolis
Minnesota	Minnesota
Minor Outlying Islands	Minor Outlying Islands
Minskaya Voblasts'	Minskaya Voblasts'
Miranda	Miranda
Misamis Occidental	Misamis Occidental
Misimi Island	Misimi Island
Misiones	Misiones
Mississippi	Mississippi
Missouri	Missouri
Misto Sevastopol'	Misto Sevastopol'
Mitiaro	Mitiaro
Miyagi	Miyagi
Miyagi Pref.	Miyagi Pref.
Miyagi Prefecture	Miyagi Prefecture
Miyagi-ken	Miyagi-ken
Miyazaki-ken	Miyazaki-ken
Mizoram	Mizoram
Mogila	Mogila
Moheli	Moheli
Moka	Moka
Moka District	Moka District
Molise	Molise
Molucca Islands	Molucca Islands
Moluccas	Moluccas
Mombasa	Mombasa
Mombassa	Mombassa
Mon State	Mon State
Monaco	Monaco
Monagas	Monagas
Monaghan	Monaghan
Mondulkiri	Mondulkiri
Mondulkiri Province	Mondulkiri Province
Mono	Mono
Mont Buxton	Mont Buxton
Mont-Liban	Mont-Liban
Montana	Montana
Monte Cristi	Monte Cristi
Montevideo	Montevideo
Montreal	Montreal
Moorea	Moorea
Moravia	Moravia
Moravia (southeastern)	Moravia (southeastern)
Moravian-Silesian Region	Moravian-Silesian Region
Moravian-silesian Region	Moravian-silesian Region
Moravskoslezsky kraj	Moravskoslezsky kraj
More og Romsdal Fylke	More og Romsdal Fylke
Morelos	Morelos
Morobe	Morobe
Morobe District	Morobe District
Morobe Province	Morobe Province
Morocco	Morocco
Morogoro	Morogoro
Morogoro District	Morogoro District
Morogoro Region	Morogoro Region
Morona Santiago	Morona Santiago
Moskva	Moskva
Mosqua	Mosqua
Mostaganem	Mostaganem
Mountain Province	Mountain Province
Moyen-Ogooue	Moyen-Ogooue
Moz	Moz
Mozambique	Mozambique
Mpumalanga	Mpumalanga
Mpumalanga Province	Mpumalanga Province
Mtwara Region	Mtwara Region
Mugla	Mugla
Muhafazat al Gharbiyah	Muhafazat al Gharbiyah
Muhafazat al Minufiyah	Muhafazat al Minufiyah
Muizenberg	Muizenberg
Muk Dahan Province	Muk Dahan Province
Mukhtori Kuhistoni Badakhshon	Mukhtori Kuhistoni Badakhshon
Mulanje District	Mulanje District
Muletupu Island	Muletupu Island
Mun. Cabo Rojo	Mun. Cabo Rojo
Mundoro	Mundoro
Munster	Munster
Murcia	Murcia
Mures	Mures
Murmansk Oblast	Murmansk Oblast
Murmanskaya Oblast	Murmanskaya Oblast
Murmanskaya Oblast'	Murmanskaya Oblast'
Murraya Koeniggi	Murraya Koeniggi
Mus	Mus
Myanmar	Myanmar
Mysore	Mysore
Mzimba District	Mzimba District
N Carolina	N Carolina
N. Bohemia	N. Bohemia
NE Bohemia	NE Bohemia
NE Territories	NE Territories
Na	Na
Nabatiye	Nabatiye
Nabeul	Nabeul
Nachingwea District	Nachingwea District
Nacional	Nacional
Nadroga-Navosa	Nadroga-Navosa
Nagaland	Nagaland
Nagano Pref.	Nagano Pref.
Nagano Prefecture	Nagano Prefecture
Nagano-ken	Nagano-ken
Nagasaki	Nagasaki
Nagasaki Prefecture	Nagasaki Prefecture
Nagasaki-ken	Nagasaki-ken
Nagorno Karabakh	Nagorno Karabakh
Nagsaki Prefecture	Nagsaki Prefecture
Nairobi	Nairobi
Nairobi County	Nairobi County
Nakai	Nakai
Nakhon Ratchasima	Nakhon Ratchasima
Nakhon Sawan	Nakhon Sawan
Nakhon Si Thammarat	Nakhon Si Thammarat
Nakura County	Nakura County
Nakuru County	Nakuru County
Namer	Namer
Namibe	Namibe
Nampula	Nampula
Namur	Namur
Nandi County	Nandi County
Nangarhar	Nangarhar
Nantou	Nantou
Naples	Naples
Napo	Napo
Nara Prefecture	Nara Prefecture
Nara-ken	Nara-ken
Narathiwat Province	Narathiwat Province
Narayani	Narayani
Narynskaya Oblast'	Narynskaya Oblast'
Nata	Nata
Natal	Natal
Natal Province	Natal Province
Natal Salt Rock	Natal Salt Rock
Natea	Natea
National Capital Dis	National Capital Dis
National Capital District	National Capital District
National Capital Region	National Capital Region
Navarra	Navarra
Naxcivan Muxtar Respublikasi	Naxcivan Muxtar Respublikasi
Nayarit	Nayarit
Nayarit State	Nayarit State
Nc-Nord	Nc-Nord
Nc-Sud	Nc-Sud
Ne	Ne
Neamt	Neamt
Near East	Near East
Nebraska	Nebraska
Neftcala Rayonu	Neftcala Rayonu
Negeri Sembilan	Negeri Sembilan
Negri Sembilan Labu	Negri Sembilan Labu
Negros	Negros
Negros Island	Negros Island
Negros Island Region	Negros Island Region
Negros Occidental	Negros Occidental
Negros Oriental	Negros Oriental
Negros Oriental Prov	Negros Oriental Prov
Negros oriental prov	Negros oriental prov
Neifang District	Neifang District
Neifeng District	Neifeng District
Nelson	Nelson
Nelson Land District	Nelson Land District
Nelson Region	Nelson Region
Neuchatel	Neuchatel
Neuquen	Neuquen
Nevada	Nevada
New Britain	New Britain
New Britain District	New Britain District
New Britain Province	New Britain Province
New Britain Province East.	New Britain Province East.
New Brunswick	New Brunswick
New Caledonia	New Caledonia
New England	New England
New George Island	New George Island
New Georgia	New Georgia
New Georgia Islands	New Georgia Islands
New Guinea	New Guinea
New Hampshire	New Hampshire
New Hamshire	New Hamshire
New Hanover	New Hanover
New Hebrides	New Hebrides
New Ire	New Ire
New Ireland	New Ireland
New Ireland District	New Ireland District
New Ireland Province	New Ireland Province
New Jersey	New Jersey
New Mexico	New Mexico
New Providence	New Providence
New Providence District	New Providence District
New South wales	New South wales
New Territories	New Territories
New York	New York
New York State	New York State
New Zealand	New Zealand
New Zealand?	New Zealand?
New jersey	New jersey
New mexico	New mexico
New south Wales	New south Wales
New south wales	New south wales
New york	New york
New york state	New york state
Newfoundland	Newfoundland
Newfoundland and Labrador	Newfoundland and Labrador
Ng	Ng
Nghe An	Nghe An
Nghe An Province	Nghe An Province
Ngounie	Ngounie
Ni	Ni
Niari	Niari
Nicosia District	Nicosia District
Niederoesterreich	Niederoesterreich
Niedersachsen	Niedersachsen
Nieder√∂sterreich	Nieder√∂sterreich
Niger	Niger
Niigata Prefecture	Niigata Prefecture
Niigata-ken	Niigata-ken
Nil	Nil
Nimba County	Nimba County
Ninawa	Ninawa
Ningxia Huizu Zizhiqu	Ningxia Huizu Zizhiqu
Ninh Binh	Ninh Binh
Ninh Thuan	Ninh Thuan
Nitra Region	Nitra Region
Nitriansky Kraj	Nitriansky Kraj
Niue	Niue
No Location	No Location
No data	No data
Noord-Brabant	Noord-Brabant
Noord-Holland	Noord-Holland
Norbotten County	Norbotten County
Nord	Nord
Nord-Kivu	Nord-Kivu
Nord-Pas-de-Calais	Nord-Pas-de-Calais
Nord-Trondelag	Nord-Trondelag
Nord-Trondelag Fylke	Nord-Trondelag Fylke
Nord-Tr√∏ndelag	Nord-Tr√∏ndelag
Nordfriesland	Nordfriesland
Nordjylland	Nordjylland
Nordland	Nordland
Nordland County	Nordland County
Nordland Fylke	Nordland Fylke
Nordland Province	Nordland Province
Nordoyar sysla	Nordoyar sysla
Nordrhein-Westfalen	Nordrhein-Westfalen
Nordrhein-Westfallen	Nordrhein-Westfallen
Nordurland Eystra	Nordurland Eystra
Nordurland Vestra	Nordurland Vestra
Norfolk	Norfolk
Norfolk Island	Norfolk Island
Norfolk Ridge	Norfolk Ridge
Norfolk island	Norfolk island
Norfoll	Norfoll
Normandie	Normandie
Normandy	Normandy
Norrbotten	Norrbotten
Norrbottens Lan	Norrbottens Lan
North Aegean	North Aegean
North America	North America
North Atlantic Ocean	North Atlantic Ocean
North Auckland Land District	North Auckland Land District
North Auckland Province	North Auckland Province
North Australia	North Australia
North Ayrshire	North Ayrshire
North Bank Division	North Bank Division
North Borneo	North Borneo
North Borneo (now Sabah)	North Borneo (now Sabah)
North Brabant	North Brabant
North Brazil	North Brazil
North Carolina	North Carolina
North Central Province	North Central Province
North Coast	North Coast
North Cotabato	North Cotabato
North Dakota	North Dakota
North Denmark Region	North Denmark Region
North Devon	North Devon
North East District	North East District
North Eastern Atlantic Ocean	North Eastern Atlantic Ocean
North European Russia	North European Russia
North Holland	North Holland
North Is	North Is
North Island	North Island
North Island,	North Island,
North Island, Auckland	North Island, Auckland
North Island, Bay of Plenty	North Island, Bay of Plenty
North Island, Southern North Island	North Island, Southern North Island
North Island, Taupo	North Island, Taupo
North Island, Volcanic Plateau	North Island, Volcanic Plateau
North Island, Wairarapa	North Island, Wairarapa
North Island.	North Island.
North Lancashire	North Lancashire
North Malaku	North Malaku
North Maluku	North Maluku
North Maluku Province	North Maluku Province
North Moluccas	North Moluccas
North Ossetia-Alania Republic	North Ossetia-Alania Republic
North Pacific Ocean	North Pacific Ocean
North Province	North Province
North Solomon Province	North Solomon Province
North Solomons	North Solomons
North Solomons Province	North Solomons Province
North Sulawesi	North Sulawesi
North Sulewesi	North Sulewesi
North Sumatra	North Sumatra
North Wales	North Wales
North West	North West
North West Australia	North West Australia
North West Province	North West Province
North West Territories	North West Territories
North Western Province	North Western Province
North Yorkshire	North Yorkshire
North and Central Mexico	North and Central Mexico
North island	North island
North sulawesi	North sulawesi
North sumatra	North sumatra
North vietnam	North vietnam
North-West	North-West
North-West Frontier Province	North-West Frontier Province
North-West Province	North-West Province
North-Western Dist.	North-Western Dist.
North-Western Province	North-Western Province
North-west Frontier Province	North-west Frontier Province
Northeast	Northeast
Northeast Argentina	Northeast Argentina
Northen Province	Northen Province
Northerm Territory	Northerm Territory
Northern	Northern
Northern Alps	Northern Alps
Northern Australia	Northern Australia
Northern Cape	Northern Cape
Northern Cape Prov.	Northern Cape Prov.
Northern Cape Province	Northern Cape Province
Northern Cooks, Manihiki/Rakahanga	Northern Cooks, Manihiki/Rakahanga
Northern Cooks, Penrhyn	Northern Cooks, Penrhyn
Northern District	Northern District
Northern Division	Northern Division
Northern Division (Oro)	Northern Division (Oro)
Northern Ireland	Northern Ireland
Northern Island	Northern Island
Northern Luzon	Northern Luzon
Northern Mindoro	Northern Mindoro
Northern Oman Sea	Northern Oman Sea
Northern Province	Northern Province
Northern Province (Oro)	Northern Province (Oro)
Northern Provinces	Northern Provinces
Northern Region	Northern Region
Northern Samar	Northern Samar
Northern Solomon	Northern Solomon
Northern Sulawesi	Northern Sulawesi
Northern Territory Northern Territory	Northern Territory Northern Territory
Northern Territory query	Northern Territory query
Northern Territory/Western Australia	Northern Territory/Western Australia
Northern district	Northern district
Northland	Northland
Northumberland	Northumberland
Northwest	Northwest
Northwest European Russia	Northwest European Russia
Northwest Mexico	Northwest Mexico
Northwest Terrirories	Northwest Terrirories
Northwest Territories	Northwest Territories
Northwestern Cape	Northwestern Cape
Norwegian Finnmark	Norwegian Finnmark
Nottinghamshire	Nottinghamshire
Noumea	Noumea
Nouvelle-Aquitaine	Nouvelle-Aquitaine
Nova Gorica	Nova Gorica
Nova Scotia	Nova Scotia
Nsanje District	Nsanje District
Nt	Nt
Ntcheu District	Ntcheu District
Nuble	Nuble
Nueva Ecija	Nueva Ecija
Nueva Vizcaya	Nueva Vizcaya
Nuevo Leon	Nuevo Leon
Nuevo Le√≥n	Nuevo Le√≥n
Nukunonu Atoll	Nukunonu Atoll
Nunavut	Nunavut
Nunku'alofa	Nunku'alofa
Nuoro	Nuoro
Nusa Tenggara	Nusa Tenggara
Nusa Tenggara Barat	Nusa Tenggara Barat
Nusa Tenggara Timur	Nusa Tenggara Timur
Nusa Tenggara Timur Province	Nusa Tenggara Timur Province
Nusa tenggara barat	Nusa tenggara barat
Nusa tenggara timur	Nusa tenggara timur
Nv	Nv
Ny	Ny
Nyanga	Nyanga
Nyanza Province	Nyanza Province
Nyingchi	Nyingchi
Nylandia	Nylandia
Nz	Nz
N√§rke	N√§rke
O'ahu	O'ahu
Oahu	Oahu
Oates Land	Oates Land
Oaxaca	Oaxaca
Oaxaca State	Oaxaca State
Oberoesterreich	Oberoesterreich
Ober√∂sterreich	Ober√∂sterreich
Obock	Obock
Obwalden	Obwalden
Occitanie	Occitanie
Odes'ka Oblast'	Odes'ka Oblast'
Odisha	Odisha
Oecussi-Ambeno	Oecussi-Ambeno
Oeno Island	Oeno Island
Ogooue-Ivindo	Ogooue-Ivindo
Ogooue-Lolo	Ogooue-Lolo
Ogooue-Maritime	Ogooue-Maritime
Ogun State	Ogun State
Oh	Oh
Ohio	Ohio
Oise	Oise
Oita Prefecture	Oita Prefecture
Oita-ken	Oita-ken
Okahandja	Okahandja
Okavango	Okavango
Okayama Prefecture	Okayama Prefecture
Okinawa	Okinawa
Okinawa Pref.	Okinawa Pref.
Okinawa Prefecture	Okinawa Prefecture
Okinawa-ken	Okinawa-ken
Oklahoma	Oklahoma
Olancho	Olancho
Olomouc Region	Olomouc Region
Olomoucky kraj	Olomoucky kraj
Olt	Olt
Oman	Oman
Ombella-M'Poko	Ombella-M'Poko
Omskaya Oblast'	Omskaya Oblast'
Ontario	Ontario
Opara Island, Rapa Iti	Opara Island, Rapa Iti
Opolskie	Opolskie
Oppland Fylke	Oppland Fylke
Or	Or
Oran	Oran
Orange County, New York	Orange County, New York
Orange Free State	Orange Free State
Orange Walk	Orange Walk
Orange Walk District	Orange Walk District
Orebro Lan	Orebro Lan
Oregan	Oregan
Oregon	Oregon
Oregon State	Oregon State
Orenburgskaya Oblast'	Orenburgskaya Oblast'
Oriental Mindoro	Oriental Mindoro
Orientale	Orientale
Oriente	Oriente
Oriente Province	Oriente Province
Orissa	Orissa
Orissa State	Orissa State
Orkney Constituency	Orkney Constituency
Oro	Oro
Oro (Northern)	Oro (Northern)
Oro Province	Oro Province
Oromiya	Oromiya
Oruzgan	Oruzgan
Osaka Prefecture	Osaka Prefecture
Osaka-fu	Osaka-fu
Oshikoto	Oshikoto
Oshskaya Oblast'	Oshskaya Oblast'
Oslo	Oslo
Oslo Fylke	Oslo Fylke
Osorno	Osorno
Ostergotlands Lan	Ostergotlands Lan
Ostfold Fylke	Ostfold Fylke
Ostrobottnia ouluensis	Ostrobottnia ouluensis
Osumi Prov.	Osumi Prov.
Osun	Osun
Osun State	Osun State
Otago	Otago
Otago Land District	Otago Land District
Other	Other
Otjozondjupa	Otjozondjupa
Ouargla	Ouargla
Oudomxay	Oudomxay
Oueme	Oueme
Ouest	Ouest
Oujda	Oujda
Oum el Bouaghi	Oum el Bouaghi
Outer Islands	Outer Islands
Overijssel	Overijssel
Oviedo	Oviedo
Oxapampa Province	Oxapampa Province
Oxfordshire	Oxfordshire
Oyo	Oyo
P'eng-hu Hsien	P'eng-hu Hsien
P'ing-tung Hsien	P'ing-tung Hsien
Pacific	Pacific
Pacific Islands	Pacific Islands
Pacific Ocean	Pacific Ocean
Pahang	Pahang
Pahang State	Pahang State
Pakistan	Pakistan
Paktia	Paktia
Palau Group	Palau Group
Palawan	Palawan
Palawan Province	Palawan Province
Palencia	Palencia
Palmerston	Palmerston
Palmerston Island	Palmerston Island
Paluan	Paluan
Pampanga	Pampanga
Pamplemousses District	Pamplemousses District
Panama	Panama
Panay	Panay
Pando	Pando
Pang Nga Province	Pang Nga Province
Pangasinan	Pangasinan
Panguna	Panguna
Panjang	Panjang
Paphos	Paphos
Paphos District	Paphos District
Papua	Papua
Papua New Guinea	Papua New Guinea
Papua Province	Papua Province
Papua province	Papua province
Papuan Islands	Papuan Islands
Para	Para
Paraguari	Paraguari
Paraiba	Paraiba
Paramaribo	Paramaribo
Parana	Parana
Pardubice Region	Pardubice Region
Pardubicky kraj	Pardubicky kraj
Parishes of St George and St David	Parishes of St George and St David
Parvan	Parvan
Pas-de-Calais	Pas-de-Calais
Pasco	Pasco
Pasco Department	Pasco Department
Pastaza	Pastaza
Patagonia	Patagonia
Patuakhali	Patuakhali
Paumotus	Paumotus
Pays De La Loire	Pays De La Loire
Pays de la Loire	Pays de la Loire
Pazardzhik	Pazardzhik
Pedemontium	Pedemontium
Pedernales	Pedernales
Pedro Gonzales Is.	Pedro Gonzales Is.
Pegu	Pegu
Pelikawa District	Pelikawa District
Peloponnese	Peloponnese
Pemagatshel Dzongkhag	Pemagatshel Dzongkhag
Pemba North Region	Pemba North Region
Pemba South Region	Pemba South Region
Pembrokeshire	Pembrokeshire
Penama Province	Penama Province
Penang	Penang
Peninsular Malaysia	Peninsular Malaysia
Pennsylvania	Pennsylvania
Penrhyn	Penrhyn
Pentecote	Pentecote
Perak	Perak
Perlis	Perlis
Perm Krai	Perm Krai
Pernambuco	Pernambuco
Pernambuco State	Pernambuco State
Pernik	Pernik
Persian Gulf	Persian Gulf
Perth Western Australia	Perth Western Australia
Perth and Kinross	Perth and Kinross
Peru	Peru
Pest megye	Pest megye
Peten	Peten
Petorca Province	Petorca Province
Phang Nha	Phang Nha
Phang-Nga	Phang-Nga
Phetchaburi Province	Phetchaburi Province
Philippines	Philippines
Phnom Penh	Phnom Penh
Phoenix Group	Phoenix Group
Phra Nakhon Si Ayutthaya	Phra Nakhon Si Ayutthaya
Phrae	Phrae
Phu Tho	Phu Tho
Phu Yen	Phu Yen
Phuket	Phuket
Piaui	Piaui
Picardy	Picardy
Pichincha	Pichincha
Pichincha Province	Pichincha Province
Piemonte	Piemonte
Pinar Del Rio	Pinar Del Rio
Pinar del R√≠o	Pinar del R√≠o
Pingtung County	Pingtung County
Pirkanmaa	Pirkanmaa
Pitcairn Island	Pitcairn Island
Pitcairn Islands	Pitcairn Islands
Plaines Wilhems	Plaines Wilhems
Plains states	Plains states
Plateau State	Plateau State
Pleven	Pleven
Plovdiv	Plovdiv
Plzen Region	Plzen Region
Plzensky kraj	Plzensky kraj
Png	Png
Podgorica	Podgorica
Podlasie	Podlasie
Podlaskie	Podlaskie
Podlaskie Voivodeship	Podlaskie Voivodeship
Pohjois-Karjala (North Karelia)	Pohjois-Karjala (North Karelia)
Pohjois-Pohjanmaa	Pohjois-Pohjanmaa
Pohjois-Pohjanmaa (Northern Ostrobothnia)	Pohjois-Pohjanmaa (Northern Ostrobothnia)
Pohjois-Savo (Northern Savonia)	Pohjois-Savo (Northern Savonia)
Pohnpei	Pohnpei
Pokrajina Vojvodina	Pokrajina Vojvodina
Polynesia	Polynesia
Pomerania	Pomerania
Pomeroon-Supenaam Region	Pomeroon-Supenaam Region
Pomorskie	Pomorskie
Ponape Island (now Pohnpei)	Ponape Island (now Pohnpei)
Ponce District	Ponce District
Pondicherry	Pondicherry
Pondoland	Pondoland
Pontevedra	Pontevedra
Port Elizabeth	Port Elizabeth
Port Elizabeth Cape	Port Elizabeth Cape
Port Louis District	Port Louis District
Port Moresby	Port Moresby
Port Moresby District	Port Moresby District
Port Stanley	Port Stanley
Port of Spain	Port of Spain
Portalegre	Portalegre
Portland	Portland
Porto Alegre	Porto Alegre
Porto Novo	Porto Novo
Portugal	Portugal
Portuguese Timor (Timor Leste)	Portuguese Timor (Timor Leste)
Possibly Papua New Guinea	Possibly Papua New Guinea
Postojna	Postojna
Potaro-Siparuni Region	Potaro-Siparuni Region
Potosi	Potosi
Prahova	Prahova
Preah Vihear	Preah Vihear
Prefecture de la Nana-Mambere	Prefecture de la Nana-Mambere
Presov Region	Presov Region
Presovsky Kraj	Presovsky Kraj
Pretoria	Pretoria
Primorskiy Kray	Primorskiy Kray
Primorsko-Goranska Zupanija	Primorsko-Goranska Zupanija
Primorsky Kray	Primorsky Kray
Prince Edward Island	Prince Edward Island
Prince Edward Islands	Prince Edward Islands
Princess Elizabeth Land	Princess Elizabeth Land
Princess elizabeth Land	Princess elizabeth Land
Principado de Asturias	Principado de Asturias
Prov. Aconcagua	Prov. Aconcagua
Prov. Almeria	Prov. Almeria
Prov. Ant√°rtica Chilena	Prov. Ant√°rtica Chilena
Prov. Carchi	Prov. Carchi
Prov. Cautin	Prov. Cautin
Prov. Chiloe	Prov. Chiloe
Prov. Chimborazo	Prov. Chimborazo
Prov. Concepcion	Prov. Concepcion
Prov. Cotopaxi	Prov. Cotopaxi
Prov. Heredia	Prov. Heredia
Prov. Hidalgo	Prov. Hidalgo
Prov. Holguin	Prov. Holguin
Prov. Imbabura	Prov. Imbabura
Prov. Kangwon	Prov. Kangwon
Prov. Kivu	Prov. Kivu
Prov. Limon	Prov. Limon
Prov. Loja	Prov. Loja
Prov. Magallanes	Prov. Magallanes
Prov. Malleco	Prov. Malleco
Prov. Napo	Prov. Napo
Prov. Oppland	Prov. Oppland
Prov. Oriente	Prov. Oriente
Prov. Osorno	Prov. Osorno
Prov. Pastaza	Prov. Pastaza
Prov. Pedernales	Prov. Pedernales
Prov. Quillota	Prov. Quillota
Prov. San Jose	Prov. San Jose
Prov. Utrecht	Prov. Utrecht
Prov. Valdivia	Prov. Valdivia
Prov. de Santiago	Prov. de Santiago
Provence	Provence
Provence-Alpes-Cote d'Azur	Provence-Alpes-Cote d'Azur
Provence-Alpes-C√¥te d'Azur	Provence-Alpes-C√¥te d'Azur
Provence-alpes-c√¥te D'azur	Provence-alpes-c√¥te D'azur
Province Aconcagua	Province Aconcagua
Province Aisen	Province Aisen
Province Biobio	Province Biobio
Province Cautin	Province Cautin
Province Chiloe	Province Chiloe
Province Coquimbo	Province Coquimbo
Province Gikongoro	Province Gikongoro
Province Gyeonggi	Province Gyeonggi
Province Hamkyongnam-do	Province Hamkyongnam-do
Province Heredia	Province Heredia
Province Kuusamo	Province Kuusamo
Province Lecce	Province Lecce
Province Llanquihue	Province Llanquihue
Province Magallanes	Province Magallanes
Province Nord	Province Nord
Province Nylandia	Province Nylandia
Province Osorno	Province Osorno
Province Puntarenas Las Cruces	Province Puntarenas Las Cruces
Province Savonia australis	Province Savonia australis
Province South Savo (ES)	Province South Savo (ES)
Province Sud	Province Sud
Province Uusimaa	Province Uusimaa
Province Valdivia	Province Valdivia
Province Valparaiso	Province Valparaiso
Province of Algarve	Province of Algarve
Province of Almeria	Province of Almeria
Province of Antique	Province of Antique
Province of Barcelona	Province of Barcelona
Province of Bari	Province of Bari
Province of Brindisi	Province of Brindisi
Province of Campobasso	Province of Campobasso
Province of Forli-Cesena	Province of Forli-Cesena
Province of Genoa	Province of Genoa
Province of Girona	Province of Girona
Province of Imperia	Province of Imperia
Province of La Spezia	Province of La Spezia
Province of Latina	Province of Latina
Province of Lecce	Province of Lecce
Province of Livorno	Province of Livorno
Province of Lucca	Province of Lucca
Province of Malaga	Province of Malaga
Province of Messina	Province of Messina
Province of Murcia	Province of Murcia
Province of Naples	Province of Naples
Province of Newfoundland & Labrador	Province of Newfoundland & Labrador
Province of Oglias	Province of Oglias
Province of Palermo	Province of Palermo
Province of Piacenza	Province of Piacenza
Province of Pisa	Province of Pisa
Province of Pontevedra	Province of Pontevedra
Province of Rimini	Province of Rimini
Province of Romblon	Province of Romblon
Province of Salerno	Province of Salerno
Province of Syracuse	Province of Syracuse
Province of Taranto	Province of Taranto
Province of Trapani	Province of Trapani
Province of Trieste	Province of Trieste
Province of Udine	Province of Udine
Province of Venice	Province of Venice
Province of the Western Cape	Province of the Western Cape
Provincia Constitucional Callao	Provincia Constitucional Callao
Provincia De Pinar Del Rio	Provincia De Pinar Del Rio
Provincia De Rio Negro	Provincia De Rio Negro
Provincia de Cabinda	Provincia de Cabinda
Provincia de Puntarenas	Provincia de Puntarenas
Provincia de Santiago del Estero	Provincia de Santiago del Estero
Provincia del Chubut	Provincia del Chubut
Provincia del Neuquen	Provincia del Neuquen
Provincia do Bie	Provincia do Bie
Provincia do Kuando Kubango	Provincia do Kuando Kubango
Provincia do Moxico	Provincia do Moxico
Provincia do Uige	Provincia do Uige
Prussia	Prussia
Ptuj	Ptuj
Puducherry	Puducherry
Puebla	Puebla
Puerto Plata	Puerto Plata
Puerto Rico	Puerto Rico
Puglia	Puglia
Pulau Obi	Pulau Obi
Pulau Pinang	Pulau Pinang
Punjab	Punjab
Puno	Puno
Punta Chaparro	Punta Chaparro
Puntarenas	Puntarenas
Puntarenas Province	Puntarenas Province
Purdy Archipelago	Purdy Archipelago
Pusan-Si	Pusan-Si
Pwani Region	Pwani Region
Pyrenees-Orientales	Pyrenees-Orientales
Qaraghandy Oblysy	Qaraghandy Oblysy
Qatar	Qatar
Qazvin	Qazvin
Qina	Qina
Qinghai	Qinghai
Qinghai Sheng	Qinghai Sheng
Quang Nam	Quang Nam
Quang Nam Province	Quang Nam Province
Quang Ngai	Quang Ngai
Quang Ninh	Quang Ninh
Quang Tri	Quang Tri
Quang Tri Province	Quang Tri Province
Quebec	Quebec
Quebrada de Piedra	Quebrada de Piedra
Queen Mary Land	Queen Mary Land
Quetzaltenango	Quetzaltenango
Quezon	Quezon
Quindio	Quindio
Quintana Roo	Quintana Roo
Qyzylorda Oblysy	Qyzylorda Oblysy
RENNELL & BELLONA PROVINCE	RENNELL & BELLONA PROVINCE
Rabat-Sale	Rabat-Sale
Rabat-Sale-Zemmour-Zaer	Rabat-Sale-Zemmour-Zaer
Radovljica	Radovljica
Raivavae	Raivavae
Raja Ampat	Raja Ampat
Rajasthan	Rajasthan
Rajshahi Division	Rajshahi Division
Rakahanga	Rakahanga
Rakata	Rakata
Rakhine State	Rakhine State
Rameswaram	Rameswaram
Ramnajar Division	Ramnajar Division
Ramu	Ramu
Ranco	Ranco
Rangpur	Rangpur
Rangpur Division	Rangpur Division
Ranong	Ranong
Rarotonga	Rarotonga
Ratanakiri	Ratanakiri
Ratchaburi Province	Ratchaburi Province
Rathdrum	Rathdrum
Red Sea	Red Sea
Reggio Calabria Province	Reggio Calabria Province
Regio Durango	Regio Durango
Region Aisen del General Carlos Ibanez del Campo	Region Aisen del General Carlos Ibanez del Campo
Region de Chaouia-Ouardigha	Region de Chaouia-Ouardigha
Region de Diourbel	Region de Diourbel
Region de Fatick	Region de Fatick
Region de Gharb-Chrarda-Beni Hssen	Region de Gharb-Chrarda-Beni Hssen
Region de Kolda	Region de Kolda
Region de Los Lagos	Region de Los Lagos
Region de Meknes-Tafilalet	Region de Meknes-Tafilalet
Region de Rabat-Sale-Zemmour-Zaer	Region de Rabat-Sale-Zemmour-Zaer
Region de Saint-Louis	Region de Saint-Louis
Region de la Araucania	Region de la Araucania
Region du Barh el Gazel	Region du Barh el Gazel
Region du Kouilou	Region du Kouilou
Region of Republican Subordination	Region of Republican Subordination
Regione Veneto	Regione Veneto
Relizane	Relizane
Rendova	Rendova
Renfrewshire	Renfrewshire
Rennell Island	Rennell Island
Rennell/Bellona	Rennell/Bellona
Republic of Panama	Republic of Panama
Retalhuleu	Retalhuleu
Reunion	Reunion
Reunion Island	Reunion Island
Rheinland	Rheinland
Rheinland-Pfalz	Rheinland-Pfalz
Rhineland-Palatinate	Rhineland-Palatinate
Rhode Is	Rhode Is
Rhode Island	Rhode Island
Rhode island	Rhode island
Rhodos	Rhodos
Rhone-Alpes	Rhone-Alpes
Riau	Riau
Ribatejo	Ribatejo
Rif Dimashq	Rif Dimashq
Rift Valley	Rift Valley
Rift Valley Province	Rift Valley Province
Ringvassoy	Ringvassoy
Rio De Janeiro	Rio De Janeiro
Rio Grande Norte	Rio Grande Norte
Rio Grande Sul	Rio Grande Sul
Rio Grande do Norte	Rio Grande do Norte
Rio Grande do Sul	Rio Grande do Sul
Rio Grandide do Sul	Rio Grandide do Sul
Rio Negro	Rio Negro
Rio Negro Province	Rio Negro Province
Rio de Janeiro	Rio de Janeiro
Rio de Janeiro State	Rio de Janeiro State
River Cess County	River Cess County
River Nile	River Nile
Rivera	Rivera
Rivers State	Rivers State
Riviere Du Rempart	Riviere Du Rempart
Rizal	Rizal
Rizal Province	Rizal Province
Rj	Rj
Rocha	Rocha
Rodrigues	Rodrigues
Rodrigues Island	Rodrigues Island
Rodriguez Island	Rodriguez Island
Rogaland	Rogaland
Rogaland Fylke	Rogaland Fylke
Romania	Romania
Romblon	Romblon
Rondonia	Rondonia
Rookery Islands	Rookery Islands
Roraima	Roraima
Ross Dependency New Zealand	Ross Dependency New Zealand
Ross sea sector	Ross sea sector
Ross-shire	Ross-shire
Rossel Island	Rossel Island
Rostovskaya Oblast	Rostovskaya Oblast
Rostovskaya Oblast'	Rostovskaya Oblast'
Rota	Rota
Rotuma Island	Rotuma Island
Rsa	Rsa
Rugia	Rugia
Rumphi District	Rumphi District
Rurutu	Rurutu
Ruse	Ruse
Russell Islands	Russell Islands
Russia	Russia
Ruvuma Region	Ruvuma Region
Ruyigi	Ruyigi
Rwanda	Rwanda
Ryanggang	Ryanggang
Ryukyu	Ryukyu
Ryukyu Archipelago	Ryukyu Archipelago
Ryukyu Islands	Ryukyu Islands
Ryukyu Islands / Loo Choo	Ryukyu Islands / Loo Choo
R√©union	R√©union
S. Bohemia	S. Bohemia
SA/NSW	SA/NSW
SA/QLD	SA/QLD
SE Sulawesi	SE Sulawesi
SW Bohemia	SW Bohemia
SW Cape Province	SW Cape Province
Sa	Sa
Sa Kaeo	Sa Kaeo
Saaremaa County	Saaremaa County
Saarland	Saarland
Sabah	Sabah
Sabaragamuwa	Sabaragamuwa
Sabaragamuwa Provinc	Sabaragamuwa Provinc
Sabaragamuwa Province	Sabaragamuwa Province
Sabu Island	Sabu Island
Sacatepequez	Sacatepequez
Sachsen	Sachsen
Sachsen-Anhalt	Sachsen-Anhalt
Sadinia	Sadinia
Safr	Safr
Saga Prefecture	Saga Prefecture
Sagaing	Sagaing
Sagaing Division	Sagaing Division
Saida	Saida
Saigon	Saigon
Saint Andrew	Saint Andrew
Saint Ann	Saint Ann
Saint Barth√©lemy	Saint Barth√©lemy
Saint Catherine	Saint Catherine
Saint Elizabeth	Saint Elizabeth
Saint George	Saint George
Saint George and Saint Patrick	Saint George and Saint Patrick
Saint Helena	Saint Helena
Saint James Parish	Saint James Parish
Saint Joseph Parish	Saint Joseph Parish
Saint Luke	Saint Luke
Saint Mark	Saint Mark
Saint Martin	Saint Martin
Saint Mary	Saint Mary
Saint Paul	Saint Paul
Saint Peter	Saint Peter
Saint Thomas	Saint Thomas
Saint Vincent	Saint Vincent
Saint-Jacut-de-la-Mer,	Saint-Jacut-de-la-Mer,
Saint-Laurent-du-Maroni	Saint-Laurent-du-Maroni
Saint-Paul-et-Amsterdam	Saint-Paul-et-Amsterdam
Saipan	Saipan
Saitama	Saitama
Saitama-ken	Saitama-ken
Sakarya	Sakarya
Sakha (Yakutiya)	Sakha (Yakutiya)
Sakhalinskaya Oblast'	Sakhalinskaya Oblast'
Sakhon Nakhon	Sakhon Nakhon
Salah ad Din	Salah ad Din
Salavan	Salavan
Salima District	Salima District
Salt	Salt
Salta	Salta
Salyan Rayonu	Salyan Rayonu
Salzburg	Salzburg
Samana	Samana
Samar	Samar
Samarqand Viloyati	Samarqand Viloyati
Samburu County	Samburu County
Samdrup Jongkhar	Samdrup Jongkhar
Samer	Samer
Samoa	Samoa
Samur	Samur
San Cristobal	San Cristobal
San Cristobal/Makira	San Cristobal/Makira
San Cristoval	San Cristoval
San Diego	San Diego
San Jose	San Jose
San Jose Province	San Jose Province
San Jos√©	San Jos√©
San Juan	San Juan
San Luis	San Luis
San Luis Potosi	San Luis Potosi
San Luis Potos√≠	San Luis Potos√≠
San Martin	San Martin
San Miguel	San Miguel
Sanaag	Sanaag
Sanchez Ramirez	Sanchez Ramirez
Sandaun	Sandaun
Sandaun (West Sepik) Province	Sandaun (West Sepik) Province
Sandaun Province	Sandaun Province
Sandwich Island	Sandwich Island
Sandwich Islands	Sandwich Islands
Sandy Point District	Sandy Point District
Sangareya Bay	Sangareya Bay
Sankt-Peterburg	Sankt-Peterburg
Sanliurfa	Sanliurfa
Sanma	Sanma
Sanma Province	Sanma Province
Santa Barbara	Santa Barbara
Santa Catarina	Santa Catarina
Santa Catarina State	Santa Catarina State
Santa Clara	Santa Clara
Santa Cruz	Santa Cruz
Santa Cruz Group	Santa Cruz Group
Santa Cruz Islands	Santa Cruz Islands
Santa Cruz Province	Santa Cruz Province
Santa Cruz, Lotufo Costanera	Santa Cruz, Lotufo Costanera
Santa Fe	Santa Fe
Santa Isabel/Ysabel	Santa Isabel/Ysabel
Santa Rosa	Santa Rosa
Santa catarina	Santa catarina
Santander	Santander
Santarem	Santarem
Santiago	Santiago
Santiago Del Estero	Santiago Del Estero
Santiago Metropolitan Region	Santiago Metropolitan Region
Santiago Rodriguez	Santiago Rodriguez
Santiago de Cuba	Santiago de Cuba
Santiago de Cuba Province	Santiago de Cuba Province
Santo	Santo
Santo Antao	Santo Antao
Santo Domingo	Santo Domingo
Santo Island	Santo Island
Sao Nicolau	Sao Nicolau
Sao Paulo	Sao Paulo
Sao Vicente	Sao Vicente
Saraburi Province	Saraburi Province
Saratovskaya Oblast'	Saratovskaya Oblast'
Saratovskaya oblast	Saratovskaya oblast
Sarawak	Sarawak
Sardegna	Sardegna
Sardinia	Sardinia
Sarigan	Sarigan
SasKatchewan	SasKatchewan
Sasia	Sasia
Saskachewan	Saskachewan
Saskatchewan	Saskatchewan
Saskatewan	Saskatewan
Satakunta	Satakunta
Satkhira	Satkhira
Satun Province	Satun Province
Saudi Arabia	Saudi Arabia
Savai'i	Savai'i
Savaii	Savaii
Savanes	Savanes
Savannakhet	Savannakhet
Savannakhet Province	Savannakhet Province
Savanne	Savanne
Savo	Savo
Savona	Savona
Savonia australis (Sa)	Savonia australis (Sa)
Saxony	Saxony
Saxony-Anhalt	Saxony-Anhalt
Sayaboury	Sayaboury
Scand	Scand
Scania	Scania
Scania County	Scania County
Scarborough	Scarborough
Schleswig - Holstein	Schleswig - Holstein
Schleswig-Holstein	Schleswig-Holstein
Schwanenstadt	Schwanenstadt
Schwyz	Schwyz
Scotland	Scotland
Scotland Clyde	Scotland Clyde
Seamont	Seamont
Seasia	Seasia
Segou Region	Segou Region
Seine & Oise	Seine & Oise
Sekong	Sekong
Selangor	Selangor
Selangor State	Selangor State
Selenge Aymag	Selenge Aymag
Sembilan	Sembilan
Semenawi K'eyih Bahri	Semenawi K'eyih Bahri
Semey Oblysy	Semey Oblysy
Semnan	Semnan
Senegal	Senegal
Sepik	Sepik
Sepik District	Sepik District
Sepik Province	Sepik Province
Sergipe	Sergipe
Serua	Serua
Seti	Seti
Setubal	Setubal
Seville	Seville
Sezana	Sezana
Sfax	Sfax
Sha`biyat Sabha	Sha`biyat Sabha
Sha`biyat Surt	Sha`biyat Surt
Shaanxi	Shaanxi
Shaanxi Province	Shaanxi Province
Shaba	Shaba
Shakawe district	Shakawe district
Shamal Kurdufan	Shamal Kurdufan
Shamal Sina'	Shamal Sina'
Shan State	Shan State
Shandong	Shandong
Shandong Province	Shandong Province
Shandong Sheng	Shandong Sheng
Shandung Province	Shandung Province
Shangdong	Shangdong
Shanghai	Shanghai
Shanghai Shi	Shanghai Shi
Shanxi Sheng	Shanxi Sheng
Shefa	Shefa
Shefa Province	Shefa Province
Shetland Constituency	Shetland Constituency
Shiga Prefecture	Shiga Prefecture
Shiga-ken	Shiga-ken
Shikimi	Shikimi
Shikoku	Shikoku
Shikuoka Pref.	Shikuoka Pref.
Shimane	Shimane
Shimane Prefecture	Shimane Prefecture
Shimane-ken	Shimane-ken
Shiselweni District	Shiselweni District
Shizouka Prefecture	Shizouka Prefecture
Shizuoka	Shizuoka
Shizuoka Pref.	Shizuoka Pref.
Shizuoka Prefecture	Shizuoka Prefecture
Shizuoka Prefecutre	Shizuoka Prefecutre
Shizuoka-ken	Shizuoka-ken
Shortland	Shortland
Shortland Islands	Shortland Islands
Shumen	Shumen
Shyghys Qazaqstan Oblysy	Shyghys Qazaqstan Oblysy
Siazan Rayon	Siazan Rayon
Siberia	Siberia
Sibiu	Sibiu
Sichuan	Sichuan
Sichuan Province	Sichuan Province
Sichuan Sheng	Sichuan Sheng
Sicilia	Sicilia
Siciliana	Siciliana
Sicily	Sicily
Sidamo Prov.	Sidamo Prov.
Sidi Bel Abbes	Sidi Bel Abbes
Siem Reap	Siem Reap
Sikasso	Sikasso
Sikkim	Sikkim
Silesia	Silesia
Silistra	Silistra
Simbu	Simbu
Simbu (Chimbu) Province	Simbu (Chimbu) Province
Simbu Province	Simbu Province
Sinai	Sinai
Sinaloa	Sinaloa
Sinaloa State	Sinaloa State
Sind	Sind
Singapore	Singapore
Singida	Singida
Sinnar	Sinnar
Sinoe County	Sinoe County
Sipaliwini	Sipaliwini
Sirdaryo	Sirdaryo
Sirdaryo Viloyati	Sirdaryo Viloyati
Sisacko-Moslavacka Zupanija	Sisacko-Moslavacka Zupanija
Sisaket	Sisaket
Sistan Va Baluchestan	Sistan Va Baluchestan
Sjaelland	Sjaelland
Sjaellandia	Sjaellandia
Skane	Skane
Skane Laen	Skane Laen
Skane Lan	Skane Lan
Skikda	Skikda
Skofljica	Skofljica
Slaskie	Slaskie
Sliema	Sliema
Sliven	Sliven
Smaland	Smaland
Smolenskaya Oblast'	Smolenskaya Oblast'
Smolyan	Smolyan
Snares Islands	Snares Islands
Soc Trang	Soc Trang
Soccoro	Soccoro
Societe	Societe
Society Islands	Society Islands
Socotra Islands	Socotra Islands
Sodermanlands Lan	Sodermanlands Lan
Sofala	Sofala
Sofala Province	Sofala Province
Sofiya	Sofiya
Sofiya-Grad	Sofiya-Grad
Sogn og Fjordane Fylke	Sogn og Fjordane Fylke
Sol	Sol
Solomo	Solomo
Solomon Islands	Solomon Islands
Solothurn	Solothurn
Somalia	Somalia
Somarai Island	Somarai Island
Somerset	Somerset
Somme	Somme
Somogy megye	Somogy megye
Songkhla	Songkhla
Songkla Province	Songkla Province
Sonora	Sonora
Sonora Guaymas	Sonora Guaymas
Sonora State	Sonora State
Sooloo Island	Sooloo Island
Sopiste	Sopiste
Soqotra	Soqotra
Sor-Trondelag Fylke	Sor-Trondelag Fylke
Sorsogon	Sorsogon
Sorsogon Province	Sorsogon Province
Sorsogon Province, Luzon	Sorsogon Province, Luzon
Soufriere	Soufriere
Souss-Massa-Draa	Souss-Massa-Draa
Sousse	Sousse
South Aegean	South Aegean
South Africa	South Africa
South America	South America
South Atlantic	South Atlantic
South Atlantic Islands	South Atlantic Islands
South Atlantic Ocean	South Atlantic Ocean
South Bohemian Region	South Bohemian Region
South Carolina	South Carolina
South Chile	South Chile
South Chimbu (Simbu) Province	South Chimbu (Simbu) Province
South Chimbu Province	South Chimbu Province
South Dakota	South Dakota
South Dakta	South Dakta
South East Asia	South East Asia
South East S. Aust.	South East S. Aust.
South East Sulawesi	South East Sulawesi
South East region	South East region
South European Russia	South European Russia
South Finland	South Finland
South Georgia	South Georgia
South Haeme	South Haeme
South Hame	South Hame
South Highland Province	South Highland Province
South Highlands	South Highlands
South Highlands Province	South Highlands Province
South Holland	South Holland
South Karelia	South Karelia
South Moravian Region	South Moravian Region
South Orkney Islands	South Orkney Islands
South Orkney Islands (total)	South Orkney Islands (total)
South Orkneys	South Orkneys
South Palawan	South Palawan
South Province	South Province
South Sandwich Islands	South Sandwich Islands
South Savo	South Savo
South Sea Island	South Sea Island
South Shan	South Shan
South Shetland Islands	South Shetland Islands
South Simbu Province	South Simbu Province
South Sulawesi	South Sulawesi
South Sulawesi Province	South Sulawesi
South Sulewesi	South Sulawesi
South Sumatra	South Sumatra
South Tirol	South Tyrol
South Tyrol	South Tyrol
South Tyrol/Trentino	South Tyrol
South Tyroli	South Tyrol
South Vietnam	South Vietnam
South Wales	South Wales
South West	South West
South West Manus	South West Manus
South Yemen	South Yemen
South carolina	South carolina
South sulawesi	South sulawesi
Southeast Brazil	Southeast Brazil
Southeastern Texas	Southeastern Texas
Southern Bohemia	Southern Bohemia
Southern Burgenland	Southern Burgenland
Southern California	Southern California
Southern Cape	Southern Cape
Southern Carolina	Southern Carolina
Southern Cooks	Southern Cooks
Southern Cooks, Aitutaki	Southern Cooks, Aitutaki
Southern Cooks, Atiu	Southern Cooks, Atiu
Southern Cooks, Mangaia	Southern Cooks, Mangaia
Southern Cooks, Rarotonga	Southern Cooks, Rarotonga
Southern District	Southern District
Southern Highlands	Southern Highlands
Southern Highlands District	Southern Highlands District
Southern Highlands Province	Southern Highlands Province
Southern Leyte	Southern Leyte
Southern Nigeria	Southern Nigeria
Southern Ocean	Southern Ocean
Southern Province	Southern Province
Southern Region	Southern Region
Southern Rhodesia	Southern Rhodesia
Southland	Southland
Southland District	Southland District
Southland Land District	Southland Land District
Southwest British Columbia	Southwest British Columbia
Southwest Mexico	Southwest Mexico
Southwest Province	Southwest Province
Southwestern Cape	Southwestern Cape
Soviet Far East	Soviet Far East
Spanish Morocco	Spanish Morocco
Splitsko-Dalmatinska Zupanija	Splitsko-Dalmatinska Zupanija
Sri Lanka	Sri Lanka
St Andrew	St Andrew
St Joseph	St Joseph
St Mark	St Mark
St Vincent	St Vincent
St. Andrew County	St. Andrew County
St. Gallen	St. Gallen
Stann Creek District	Stann Creek District
Star Mountains, West Papua	Star Mountains, West Papua
Stara Zagora	Stara Zagora
State of Inhambane	State of Inhambane
State of Kosrae	State of Kosrae
State of Sarawak	State of Sarawak
States of Mexico & Puebla	States of Mexico & Puebla
Steiermark	Steiermark
Steirmark	Steirmark
Sth Aust	Sth Aust
Sth Aust.	Sth Aust.
Stockholm	Stockholm
Stockholms Lan	Stockholms Lan
Stoeng Treng	Stoeng Treng
Strait of Gibraltar	Strait of Gibraltar
Straits of Magellan	Straits of Magellan
Straseni	Straseni
Stredocesky kraj	Stredocesky kraj
Styria	Styria
Sub Antarctic Islands	Sub Antarctic Islands
Sub antarctic island	Sub antarctic island
Sub-Antarctic	Sub-Antarctic
Sub-Antarctic Island	Sub-Antarctic Island
Subant	Subant
Subcarpathia	Subcarpathia
Suceava	Suceava
Sucre	Sucre
Sud	Sud
Sud-Comoe	Sud-Comoe
Sud-Ouest	Sud-Ouest
Sud. Norwegian	Sud. Norwegian
Sudurland	Sudurland
Suffolk	Suffolk
Sughd	Sughd
Sul do Save	Sul do Save
Sula Islands	Sula Islands
Sulawesi	Sulawesi
Sulawesi Selatan	Sulawesi Selatan
Sulawesi Tengah	Sulawesi Tengah
Sulawesi Tengarra	Sulawesi Tengarra
Sulawesi Tenggara	Sulawesi Tenggara
Sulawesi Utara	Sulawesi Utara
Sulawesi selatan	Sulawesi selatan
Sulaymaniyah	Sulaymaniyah
Sulewesi	Sulewesi
Sulu	Sulu
Sulu Archipelago	Sulu Archipelago
Sulu Province	Sulu Province
Sulu Sea	Sulu Sea
Sumale	Sumale
Sumatera	Sumatera
Sumatera Barat	Sumatera Barat
Sumatera Selatan	Sumatera Selatan
Sumatera Utara	Sumatera Utara
Sumatra	Sumatra
Sumatra barat	Sumatra barat
Sumba	Sumba
Sumbawa	Sumbawa
Summerstrand	Summerstrand
Sums'ka Oblast'	Sums'ka Oblast'
Surat Tani	Surat Tani
Surat Thani	Surat Thani
Surath Thani	Surath Thani
Surigao	Surigao
Surigao City	Surigao City
Surigao Del Norte	Surigao Del Norte
Surigao Province	Surigao Province
Surigao del Sur	Surigao del Sur
Surry	Surry
Surxondaryo Viloyati	Surxondaryo Viloyati
Susa Rayonu	Susa Rayonu
Sussex	Sussex
Suva	Suva
Suwarrow	Suwarrow
Suways	Suways
Svalbard	Svalbard
Svalbard Territory	Svalbard Territory
Swe	Swe
Sweden	Sweden
Swietokrzyskie	Swietokrzyskie
Switzerland	Switzerland
Syddanmark	Syddanmark
Sylhet Division	Sylhet Division
Syunik'i Marz	Syunik'i Marz
Szabolcs-Szatmar-Bereg megye	Szabolcs-Szatmar-Bereg megye
Szerednye	Szerednye
T'ai-nan Hsien	T'ai-nan Hsien
T'ai-pei Hsien	T'ai-pei Hsien
T'ai-pei Shih	T'ai-pei Shih
T'ao-yuan Hsien	T'ao-yuan Hsien
TERRITORY OF WALLIS & FUTUNA ISLANDS	TERRITORY OF WALLIS & FUTUNA ISLANDS
Tab Island	Tab Island
Tabasco	Tabasco
Tabasco State	Tabasco State
Table Bay	Table Bay
Taboga Island	Taboga Island
Tachira	Tachira
Tacna	Tacna
Tadla-Azilal	Tadla-Azilal
Tafea	Tafea
Tafea Province	Tafea Province
Tahiti	Tahiti
Tahoua	Tahoua
Tai-pei	Tai-pei
Taichung County	Taichung County
Taipei	Taipei
Taita Taveta	Taita Taveta
Tak	Tak
Tak Province	Tak Province
Takeo	Takeo
Talasskaya Oblast'	Talasskaya Oblast'
Talca	Talca
Tamaulipas	Tamaulipas
Tamil Nadu	Tamil Nadu
Tamil nadu	Tamil nadu
Tanga	Tanga
Tanga Region	Tanga Region
Tanganyika	Tanganyika
Tanger-Tetouan	Tanger-Tetouan
Tangier	Tangier
Tango Prov.	Tango Prov.
Tanimbar	Tanimbar
Tanimbar Islands	Tanimbar Islands
Tanintharyi Division	Tanintharyi Division
Tanna	Tanna
Tanna Island	Tanna Island
Tanzania	Tanzania
Tarabulus	Tarabulus
Taranaki	Taranaki
Taranaki Land District	Taranaki Land District
Tarapaca Province	Tarapaca Province
Tarija	Tarija
Tarlac	Tarlac
Tarragona	Tarragona
Tartar Rayonu	Tartar Rayonu
Tartumaa	Tartumaa
Tasman Sea	Tasman Sea
Tatarstan	Tatarstan
Taveuni	Taveuni
Tawi-Tawi	Tawi-Tawi
Tawi-Tawi Province	Tawi-Tawi Province
Tay Ninh	Tay Ninh
Tay Ninh Province	Tay Ninh Province
Tayabas Province	Tayabas Province
Tehran	Tehran
Teignmouth	Teignmouth
Tel Aviv District	Tel Aviv District
Telemark	Telemark
Telemark Fylke	Telemark Fylke
Teloa	Teloa
Temotu	Temotu
Temotu Province	Temotu Province
Tenerife	Tenerife
Tenerife Island	Tenerife Island
Tennesee	Tennesee
Tennessee	Tennessee
Ter	Ter
Terengganu	Terengganu
Tergeste	Tergeste
Terre Adelie	Terre Adelie
Territorio Federal Amazonas	Territorio Federal Amazonas
Territory of Ashmore and Cartier Islands	Territory of Ashmore and Cartier Islands
Territory of Cocos (Keeling) Islands	Territory of Cocos (Keeling) Islands
Territory of Heard Island and McDonald Islands	Territory of Heard Island and McDonald Islands
Territory of New Guinea	Territory of New Guinea
Territory of Norfolk Island	Territory of Norfolk Island
Territory of South Georgia and the South Sandwich Islands	Territory of South Georgia and the South Sandwich Islands
Territory of St Helena	Territory of St Helena
Territory of the French Southern and Antarctic Lands	Territory of the French Southern and Antarctic Lands
Terschelling	Terschelling
Tessin	Tessin
Tete	Tete
Tetouan	Tetouan
Tetovo	Tetovo
Texas	Texas
Thaba-Tseka District	Thaba-Tseka District
Thailand	Thailand
Thanh Hoa	Thanh Hoa
Thanh pho Ho Chi Minh	Thanh pho Ho Chi Minh
The Bahamas	The Bahamas
The Northern Territory	The Northern Territory
Thessaly	Thessaly
Thio	Thio
Three Kings Islands	Three Kings Islands
Thu Do Ha Noi	Thu Do Ha Noi
Thua Thien Hue	Thua Thien Hue
Thua Thien-Hue	Thua Thien-Hue
Thuringia	Thuringia
Tibet	Tibet
Tibet Autonomous Region	Tibet Autonomous Region
Tibet-Qinghai	Tibet-Qinghai
Ticao Island	Ticao Island
Ticino	Ticino
Ticoa Island	Ticoa Island
Tien Giang	Tien Giang
Tierra Del Fuego	Tierra Del Fuego
Tierra de Fuego	Tierra de Fuego
Tierra del Fuego	Tierra del Fuego
Tierra del Fuego Province	Tierra del Fuego Province
Tigray	Tigray
Tim	Tim
Timaru	Timaru
Timis	Timis
Timor	Timor
Timor sea	Timor sea
Tinian	Tinian
Tipaza	Tipaza
Tiritiri Island	Tiritiri Island
Tirol	Tirol
Tizi Ouzou	Tizi Ouzou
Tlaxcala	Tlaxcala
Tlemcen	Tlemcen
Toamasina	Toamasina
Tobago	Tobago
Tocantins	Tocantins
Tochigi Pref.	Tochigi Pref.
Tochigi Prefecture	Tochigi Prefecture
Tochigi-ken	Tochigi-ken
Tochigo	Tochigo
Toga Island	Toga Island
Togian Islands	Togian Islands
Tokat	Tokat
Tokelau	Tokelau
Tokushima Prefecture	Tokushima Prefecture
Tokushima-ken	Tokushima-ken
Tokyo	Tokyo
Tokyo Pref.	Tokyo Pref.
Tokyo Prefecture	Tokyo Prefecture
Tokyo-to	Tokyo-to
Toledo District	Toledo District
Toliara	Toliara
Tolima	Tolima
Tolmin	Tolmin
Tolna megye	Tolna megye
Tomskaya Oblast'	Tomskaya Oblast'
Tonga	Tonga
Tongatapu	Tongatapu
Tooa Bay	Tooa Bay
Torba Province	Torba Province
Torres Group	Torres Group
Tosa	Tosa
Toscana	Toscana
Toshkent Shahri	Toshkent Shahri
Toshkent Viloyati	Toshkent Viloyati
Tottori-ken	Tottori-ken
Touho	Touho
Tov Province	Tov Province
Tozeur	Tozeur
Trabzon	Trabzon
Trad Province	Trad Province
Trang Province	Trang Province
Trangan Island	Trangan Island
Trans Nzoia County	Trans Nzoia County
Transilvania	Transilvania
Transvaal	Transvaal
Transylvania	Transylvania
Transylvannia	Transylvannia
Trapani	Trapani
Trapani Province	Trapani Province
Tras-Os-Montes	Tras-Os-Montes
Trashigang Dzongkhag	Trashigang Dzongkhag
Trat Province	Trat Province
Travancore	Travancore
Trenciansky Kraj	Trenciansky Kraj
Trencin Region	Trencin Region
Trentino	Trentino
Trentino-Alto Adige	Trentino-Alto Adige
Tres Marias	Tres Marias
Treviso	Treviso
Triesenberg	Triesenberg
Trinidad	Trinidad
Trinidad and Tobago	Trinidad and Tobago
Trista da Cunha	Trista da Cunha
Tristan Da Cunha	Tristan Da Cunha
Tristan da Cunha	Tristan da Cunha
Tristan da Cunha group	Tristan da Cunha group
Trnava Region	Trnava Region
Trnavsky Kraj	Trnavsky Kraj
Trobriand Is	Trobriand Is
Trobriand Island	Trobriand Island
Trobriand Islands	Trobriand Islands
Troms Fylke	Troms Fylke
Trongsa Dzongkhag	Trongsa Dzongkhag
Trujillo	Trujillo
Trzic	Trzic
Tsirang Dzongkhag	Tsirang Dzongkhag
Tsitsikamma	Tsitsikamma
Tuamotu	Tuamotu
Tuamotu-Gambier	Tuamotu-Gambier
Tuamotus Islands	Tuamotus Islands
Tubuai	Tubuai
Tucuman	Tucuman
TucumÔøΩn	TucumÔøΩn
Tucum√°n	Tucum√°n
Tukuma Rajons	Tukuma Rajons
Tulcea	Tulcea
Tulcea County	Tulcea County
Tunapuna-Piarco	Tunapuna-Piarco
Tungurahua	Tungurahua
Tunis	Tunis
Tunisia	Tunisia
Tunu	Tunu
Turgovishte	Turgovishte
Turkey	Turkey
Tuscany	Tuscany
Tuyen Quang	Tuyen Quang
Tuyen Quang Province	Tuyen Quang Province
Tverskaya Oblast'	Tverskaya Oblast'
Tx	Tx
Tyrol	Tyrol
Tyrol Province	Tyrol Province
Tyumen Oblast	Tyumen Oblast
Tyumenskaya Oblast'	Tyumenskaya Oblast'
Tyva	Tyva
U.P.	U.P.
US Minor Outlying Is	US Minor Outlying Is
US Virgin Islands	US Virgin Islands
Uige	Uige
Uitenhage	Uitenhage
Uk	Uk
Ulster	Ulster
Ultima Esperanza	Ultima Esperanza
Umbria	Umbria
Union Province	Union Province
Unity	Unity
Unk	Unk
Upolu	Upolu
Upper Austria	Upper Austria
Upper Demerara-Berbice Region	Upper Demerara-Berbice Region
Upper Nile	Upper Nile
Upper River Division	Upper River Division
Upper Silesia	Upper Silesia
Upper Takutu-Upper Essequibo	Upper Takutu-Upper Essequibo
Upper Takutu-Upper Essequibo Region	Upper Takutu-Upper Essequibo Region
Uppland	Uppland
Uppsala Lan	Uppsala Lan
Uracas	Uracas
Uri	Uri
Urubamba Province	Urubamba Province
Usak	Usak
Ustecky kraj	Ustecky kraj
Utah	Utah
Utian Island	Utian Island
Utrecht	Utrecht
Uttar Pradesh	Uttar Pradesh
Uttarakhand	Uttarakhand
Utuado	Utuado
Uusimaa	Uusimaa
Uusimaa (Nylandia)	Uusimaa (Nylandia)
Uva	Uva
Uva Province	Uva Province
Uvs Aymag	Uvs Aymag
Valais	Valais
Valcea	Valcea
Valdivia	Valdivia
Valdivia Province	Valdivia Province
Valdostana	Valdostana
Valencia	Valencia
Valenciana	Valenciana
Valgamaa	Valgamaa
Valladolid	Valladolid
Valle Fontanalba	Valle Fontanalba
Valle d'Aosta	Valle d'Aosta
Valle de Cauca	Valle de Cauca
Valle del Cauca	Valle del Cauca
Valle del Cauca Department	Valle del Cauca Department
Vallee du Bandama	Vallee du Bandama
Valparaiso	Valparaiso
Valparaiso Province	Valparaiso Province
Valverde	Valverde
Vancouver	Vancouver
Vancouver Island	Vancouver Island
Vanua Levu	Vanua Levu
Varazdinska Zupanija	Varazdinska Zupanija
Vargas	Vargas
Varmlands Lan	Varmlands Lan
Varna	Varna
Varsinais-Suomi	Varsinais-Suomi
Varsinais-Suomi (Southwest Finland)	Varsinais-Suomi (Southwest Finland)
Vas megye	Vas megye
Vaslui	Vaslui
Vasterbottens Lan	Vasterbottens Lan
Vastergotland	Vastergotland
Vasternorrlands Lan	Vasternorrlands Lan
Vastmanlands Lan	Vastmanlands Lan
Vastra Gotaland	Vastra Gotaland
Vastra Gotalands Lan	Vastra Gotalands Lan
Vaucluse	Vaucluse
Vaud	Vaud
Vavuniya	Vavuniya
Vayots' Dzori Marz	Vayots' Dzori Marz
Veliko Turnovo	Veliko Turnovo
Vella lavella & New Georgia	Vella lavella & New Georgia
Vendee Department	Vendee Department
Venetia	Venetia
Veneto	Veneto
Venezuela	Venezuela
Vera Cruz	Vera Cruz
Veracruz	Veracruz
Veracruz State	Veracruz State
Veracruz state	Veracruz state
Veracruz-Llave	Veracruz-Llave
Veraguas	Veraguas
Veraguas Province	Veraguas Province
Vermont	Vermont
Verona	Verona
Verrieres	Verrieres
Vest-Agder	Vest-Agder
Vest-Agder Fylke	Vest-Agder Fylke
Vestfold Fylke	Vestfold Fylke
Vestgronland	Vestgronland
Veszprem	Veszprem
Veszprem megye	Veszprem megye
Vidin	Vidin
Vienna	Vienna
Vientiane	Vientiane
Vientiane City	Vientiane City
Vii Region Del Maule	Vii Region Del Maule
Villa Clara	Villa Clara
Villa Clara Province	Villa Clara Province
Villa Guillermina	Villa Guillermina
Vinh Phu Province	Vinh Phu Province
Vinh Phuc	Vinh Phuc
Vipava	Vipava
Viqueque	Viqueque
Viqueque District	Viqueque District
Viqueque district	Viqueque district
Virgin Islands	Virgin Islands
Virgin islands	Virgin islands
Virgina/West Virginia	Virgina/West Virginia
Virginia	Virginia
Virginia/ West Virginia	Virginia/ West Virginia
Viterbo	Viterbo
Viti	Viti
Viti Island	Viti Island
Viti Levu	Viti Levu
Vitsyebskaya Voblasts'	Vitsyebskaya Voblasts'
Vlaams Brabant	Vlaams Brabant
Vladimirskaya Oblast'	Vladimirskaya Oblast'
Volgograd Oblast	Volgograd Oblast
Volgogradskaya Oblast'	Volgogradskaya Oblast'
Voralberg.	Voralberg.
Vorarlberg	Vorarlberg
Voronezhskaya Oblast'	Voronezhskaya Oblast'
Vorumaa	Vorumaa
Vrancea	Vrancea
Vratsa	Vratsa
W Kent	W Kent
W. Bohemia	W. Bohemia
W. Cape	W. Cape
Waikato	Waikato
Wakayama	Wakayama
Wakayama Prefecture	Wakayama Prefecture
Wakayama-ken	Wakayama-ken
Wakayana	Wakayana
Wales	Wales
Wallis	Wallis
Wallonia	Wallonia
Wareng County	Wareng County
Warminsko-Mazurskie	Warminsko-Mazurskie
Warrap	Warrap
Warwick	Warwick
Warwickshire	Warwickshire
Washington	Washington
Washington County	Washington County
Washington DC	Washington DC
Washington State	Washington State
Washington state	Washington state
Washington, Seattle	Washington, Seattle
Wasia	Wasia
Wellington	Wellington
Wellington Land District	Wellington Land District
Wellington Region	Wellington Region
West Bank	West Bank
West Bengal	West Bengal
West Cape	West Cape
West Coast	West Coast
West Falklands	West Falklands
West Flores	West Flores
West Greece	West Greece
West Highlands	West Highlands
West Indies	West Indies
West Irian	West Irian
West Java	West Java
West Java Province	West Java Province
West Kalimantan	West Kalimantan
West Macedonia	West Macedonia
West Malaysia	West Malaysia
West Mexico	West Mexico
West New Britain	West New Britain
West New Britain District	West New Britain District
West New Britain Province	West New Britain Province
West Nusa Tenggara	West Nusa Tenggara
West Papua	West Papua
West Papua Province	West Papua Province
West Papua.	West Papua.
West Pokot County	West Pokot County
West Sepik	West Sepik
West Sepik (Sandaun) Province	West Sepik (Sandaun) Province
West Sepik District	West Sepik District
West Sepik Province	West Sepik Province
West Siberia	West Siberia
West Sulawesi	West Sulawesi
West Sumatra	West Sumatra
West Sussex	West Sussex
West Timor	West Timor
West Virginia	West Virginia
West Wales	West Wales
West coast	West coast
West java	West java
West papua	West papua
West papua province	West papua province
West sepik province	West sepik province
West timor	West timor
West-Central Brazil	West-Central Brazil
WestEurope	WestEurope
Western Bahr el-Ghazal	Western Bahr el-Ghazal
Western Cape.	Western Cape.
Western District	Western District
Western Division	Western Division
Western Equatoria	Western Equatoria
Western Highlands	Western Highlands
Western Highlands District	Western Highlands District
Western Highlands Province	Western Highlands Province
Western Himalaya	Western Himalaya
Western Hubei	Western Hubei
Western Hubei Province	Western Hubei Province
Western Prov.	Western Prov.
Western Province	Western Province
Western Region	Western Region
Western Sahara	Western Sahara
Western Samoa, Savai'i	Western Samoa, Savai'i
Western Samoa, Upolu	Western Samoa, Upolu
Western Tanzania	Western Tanzania
Western Tobago	Western Tobago
Western Victoria	Western Victoria
Western Visayas	Western Visayas
Western cape	Western cape
Western province	Western province
Western states	Western states
Westland Land District	Westland Land District
Westland Province	Westland Province
Westmorland	Westmorland
Whanganui	Whanganui
White Nile Province	White Nile Province
Wielkopolska	Wielkopolska
Wielkopolskie	Wielkopolskie
Wien	Wien
Wigtownshire	Wigtownshire
Wilaya de Djelfa	Wilaya de Djelfa
Wilayat-e Badakhshan	Wilayat-e Badakhshan
Wilayat-e Badghis	Wilayat-e Badghis
Wilayat-e Baghlan	Wilayat-e Baghlan
Wilayat-e Balkh	Wilayat-e Balkh
Wilayat-e Daykundi	Wilayat-e Daykundi
Wilayat-e Farah	Wilayat-e Farah
Wilayat-e Ghazni	Wilayat-e Ghazni
Wilayat-e Ghor	Wilayat-e Ghor
Wilayat-e Helmand	Wilayat-e Helmand
Wilayat-e Herat	Wilayat-e Herat
Wilayat-e Jowzjan	Wilayat-e Jowzjan
Wilayat-e Kandahar	Wilayat-e Kandahar
Wilayat-e Kunduz	Wilayat-e Kunduz
Wilayat-e Laghman	Wilayat-e Laghman
Wilayat-e Parwan	Wilayat-e Parwan
Wilayat-e Samangan	Wilayat-e Samangan
Wilayat-e Sar-e Pul	Wilayat-e Sar-e Pul
Wilayat-e Uruzgan	Wilayat-e Uruzgan
Wilayat-e Wardak	Wilayat-e Wardak
Wilayat-e Zabul	Wilayat-e Zabul
Wilkes Land	Wilkes Land
Wiltshire	Wiltshire
Windes	Windes
Windhoek	Windhoek
Windward Islands	Windward Islands
Wisconsin	Wisconsin
Woleu-Ntem	Woleu-Ntem
Worcestershire	Worcestershire
Worodougou	Worodougou
Wyomin	Wyomin
Wyoming	Wyoming
Xanlar Rayonu	Xanlar Rayonu
Xiamen	Xiamen
Xinjiang Uygur Zizhiqu	Xinjiang Uygur Zizhiqu
Yamagata-ken	Yamagata-ken
Yamaguchi Prefecture	Yamaguchi Prefecture
Yamanashi-ken	Yamanashi-ken
Yambol	Yambol
Yangon Division	Yangon Division
Yanuca Island	Yanuca Island
Yap	Yap
Yaroslavskaya Oblast'	Yaroslavskaya Oblast'
Yazd	Yazd
YeDebub Biheroch Bihereseboch na Hizboch	YeDebub Biheroch Bihereseboch na Hizboch
Yemen	Yemen
Yen Bai	Yen Bai
Yorkshire	Yorkshire
Yoro	Yoro
Ysabel Province	Ysabel Province
Ysyk-Kol Oblasty	Ysyk-Kol Oblasty
Yucatan	Yucatan
Yucat√°n	Yucat√°n
Yukon	Yukon
Yukon Territory	Yukon Territory
Yule Island	Yule Island
Yun-lin Hsien	Yun-lin Hsien
Yunnan	Yunnan
Yunnan Prov.	Yunnan Prov.
Yunnan Province	Yunnan Province
Yunnan Sheng	Yunnan Sheng
Yuzhno-Kazakhstanskaya Oblast'	Yuzhno-Kazakhstanskaya Oblast'
Zacatecas	Zacatecas
Zachodniopomorskie	Zachodniopomorskie
Zadarska Zupanija	Zadarska Zupanija
Zaghouan	Zaghouan
Zagorje ob Savi	Zagorje ob Savi
Zagrebacka Zupanija	Zagrebacka Zupanija
Zaire	Zaire
Zakarpats'ka Oblast'	Zakarpats'ka Oblast'
Zala megye	Zala megye
Zambales	Zambales
Zambales Province	Zambales Province
Zambezia	Zambezia
Zamboanga City	Zamboanga City
Zamboanga Peninsula	Zamboanga Peninsula
Zamboanga Sibugay	Zamboanga Sibugay
Zamora Chinchipe	Zamora Chinchipe
Zanzan	Zanzan
Zanzibar	Zanzibar
Zanzibar Central/South Region	Zanzibar Central/South Region
Zanzibar Urban/West Region	Zanzibar Urban/West Region
Zanzibar Urban/west	Zanzibar Urban/west
Zealand	Zealand
Zeeland	Zeeland
Zeeland Holland	Zeeland Holland
Zhambyl Oblysy	Zhambyl Oblysy
Zhejiang	Zhejiang
Zhejiang Sheng	Zhejiang Sheng
Zhuhai	Zhuhai
Zilinsky Kraj	Zilinsky Kraj
Zimbabwe	Zimbabwe
Zirovnica	Zirovnica
Zlin	Zlin
Zlinsky kraj	Zlinsky kraj
Zomba District	Zomba District
Zou	Zou
Zug	Zug
Zuid-Holland	Zuid-Holland
Zulia	Zulia
Zululand	Zululand
Zurich	Zurich